date,area_code,market,market_size,inventory,Cost Price of Goods,Selling Price,Gross profit,Marketing budget to sell the Products,operational cost on product,Net profit,total_expenses,Total Product Sold,product_line,product_type,product,state,target_cogs,target_margin,target_profit,target_sales,type,difference_between_actual_and_target_profit
2012-11-01T00:00:00,203,East,Small Market,809,36,90,54,10,11,33,21,90,Leaves,Tea,Green Tea,Connecticut,30,60,40,90,Regular,-7
2013-10-01T00:00:00,203,East,Small Market,375,47,111,64,15,18,31,43,118,Beans,Espresso,Decaf Espresso,Connecticut,30,60,50,90,Decaf,-19
2013-11-01T00:00:00,203,East,Small Market,809,36,90,54,10,-5,49,21,96,Leaves,Tea,Green Tea,Connecticut,30,60,40,90,Regular,9
2013-12-01T00:00:00,203,East,Small Market,1075,63,139,76,19,4,53,40,148,Leaves,Herbal Tea,Mint,Connecticut,40,60,40,100,Decaf,13
2013-10-01T00:00:00,203,East,Small Market,593,79,177,98,30,18,50,64,189,Leaves,Herbal Tea,Lemon,Connecticut,40,50,30,90,Decaf,20
2013-10-01T00:00:00,203,East,Small Market,1053,65,142,77,20,5,52,42,151,Leaves,Herbal Tea,Mint,Connecticut,30,50,50,80,Decaf,2
2013-10-01T00:00:00,203,East,Small Market,806,24,60,36,6,3,27,18,64,Leaves,Tea,Green Tea,Connecticut,20,40,40,60,Regular,-13
2013-11-01T00:00:00,203,East,Small Market,380,53,124,71,17,15,39,45,132,Beans,Espresso,Decaf Espresso,Connecticut,50,70,40,120,Decaf,-1
2013-12-01T00:00:00,203,East,Small Market,392,49,114,65,16,18,31,44,121,Beans,Espresso,Decaf Espresso,Connecticut,40,70,40,110,Decaf,-9
2013-12-01T00:00:00,203,East,Small Market,627,55,131,76,49,30,-3,78,140,Beans,Espresso,Caffe Mocha,Connecticut,50,70,10,120,Regular,-13
2012-11-01T00:00:00,203,East,Small Market,613,61,147,86,55,29,2,84,147,Beans,Espresso,Caffe Mocha,Connecticut,60,80,10,140,Regular,-8
2012-10-01T00:00:00,203,East,Small Market,606,60,144,84,54,29,1,83,144,Beans,Espresso,Caffe Mocha,Connecticut,40,90,40,130,Regular,-39
2012-11-01T00:00:00,203,East,Small Market,1134,130,325,195,42,31,122,73,325,Beans,Coffee,Colombian,Connecticut,110,180,130,290,Regular,-8
2012-12-01T00:00:00,203,East,Small Market,1166,115,289,174,37,32,105,69,289,Beans,Coffee,Colombian,Connecticut,100,160,110,260,Regular,-5
2013-10-01T00:00:00,203,East,Small Market,1119,125,313,188,41,-24,171,73,334,Beans,Coffee,Colombian,Connecticut,100,160,130,260,Regular,41
2013-11-01T00:00:00,203,East,Small Market,1134,130,325,195,42,-28,181,73,346,Beans,Coffee,Colombian,Connecticut,110,180,130,290,Regular,51
2012-11-01T00:00:00,206,West,Small Market,613,61,147,86,55,30,1,85,147,Leaves,Tea,Green Tea,Washington,40,60,0,100,Regular,1
2013-11-01T00:00:00,206,West,Small Market,391,54,121,67,20,28,19,54,129,Beans,Espresso,Caffe Mocha,Washington,50,60,20,110,Regular,-1
2012-10-01T00:00:00,206,West,Small Market,329,60,159,99,18,24,57,42,159,Leaves,Tea,Darjeeling,Washington,20,50,40,70,Regular,17
2012-11-01T00:00:00,206,West,Small Market,454,49,120,71,15,22,34,37,120,Leaves,Tea,Earl Grey,Washington,30,50,30,80,Regular,4
2013-11-01T00:00:00,206,West,Small Market,454,49,120,71,15,6,50,37,128,Leaves,Tea,Earl Grey,Washington,30,50,30,80,Regular,20
2012-10-01T00:00:00,206,West,Small Market,606,60,144,84,54,30,0,84,144,Leaves,Tea,Green Tea,Washington,20,40,10,60,Regular,-10
2013-10-01T00:00:00,206,West,Small Market,606,60,144,84,54,30,0,84,153,Leaves,Tea,Green Tea,Washington,20,40,10,60,Regular,-10
2013-12-01T00:00:00,206,West,Small Market,567,24,56,32,7,6,19,19,60,Beans,Espresso,Caffe Latte,Washington,20,30,20,50,Regular,-1
2012-11-01T00:00:00,206,West,Small Market,1063,75,164,89,23,21,45,44,164,Beans,Espresso,Decaf Espresso,Washington,70,80,40,150,Decaf,5
2012-10-01T00:00:00,206,West,Small Market,438,68,167,99,21,22,56,43,167,Beans,Coffee,Colombian,Washington,90,140,110,230,Regular,-54
2012-10-01T00:00:00,206,West,Small Market,573,22,51,29,7,12,10,19,51,Beans,Espresso,Caffe Latte,Washington,10,20,20,30,Regular,-10
2012-10-01T00:00:00,206,West,Small Market,1119,125,313,188,41,32,115,73,313,Leaves,Herbal Tea,Chamomile,Washington,90,160,130,250,Decaf,-15
2012-11-01T00:00:00,206,West,Small Market,1134,130,325,195,42,31,122,73,325,Leaves,Herbal Tea,Chamomile,Washington,120,180,120,300,Decaf,2
2013-10-01T00:00:00,206,West,Small Market,683,96,230,134,87,22,25,117,245,Beans,Coffee,Decaf Irish Cream,Washington,140,190,100,330,Decaf,-75
2013-10-01T00:00:00,206,West,Small Market,573,22,51,29,7,7,15,19,54,Beans,Espresso,Caffe Latte,Washington,10,20,20,30,Regular,-5
2013-11-01T00:00:00,206,West,Small Market,1134,130,325,195,42,-28,181,73,346,Leaves,Herbal Tea,Chamomile,Washington,120,180,120,300,Decaf,61
2013-12-01T00:00:00,206,West,Small Market,716,105,250,145,95,20,30,125,266,Beans,Coffee,Decaf Irish Cream,Washington,120,170,50,290,Decaf,-20
2012-10-01T00:00:00,209,West,Major Market,580,76,187,111,21,11,79,32,187,Leaves,Tea,Earl Grey,California,30,50,50,80,Regular,29
2012-10-01T00:00:00,209,West,Major Market,541,39,90,51,12,13,26,25,90,Leaves,Herbal Tea,Mint,California,20,40,40,60,Decaf,-14
2013-11-01T00:00:00,209,West,Major Market,659,75,189,114,24,2,88,55,201,Leaves,Tea,Green Tea,California,50,80,40,130,Regular,48
2012-12-01T00:00:00,209,West,Major Market,1744,247,576,329,81,32,216,113,576,Beans,Espresso,Decaf Espresso,California,240,310,210,550,Decaf,6
2013-12-01T00:00:00,209,West,Major Market,1744,247,576,329,81,-73,321,113,614,Beans,Espresso,Decaf Espresso,California,240,310,210,550,Decaf,111
2013-12-01T00:00:00,209,West,Major Market,2947,127,102,-25,40,66,-131,63,109,Beans,Coffee,Amaretto,California,150,-30,-90,120,Regular,-41
2012-11-01T00:00:00,210,South,Major Market,589,50,123,73,14,11,48,25,123,Beans,Espresso,Decaf Espresso,Texas,30,60,40,90,Decaf,8
2012-10-01T00:00:00,210,South,Major Market,915,123,302,179,34,12,133,46,302,Beans,Espresso,Caffe Mocha,Texas,70,120,100,190,Regular,33
2012-12-01T00:00:00,212,East,Major Market,3641,135,66,-69,122,33,-224,155,66,Beans,Espresso,Caffe Mocha,New York,130,-70,-210,60,Regular,-14
2013-10-01T00:00:00,212,East,Major Market,1197,239,765,526,66,-186,646,91,815,Beans,Espresso,Regular Espresso,New York,210,510,450,720,Regular,196
2012-12-01T00:00:00,213,West,Major Market,677,67,168,101,22,32,47,54,168,Leaves,Tea,Green Tea,California,40,80,50,120,Regular,-3
2012-11-01T00:00:00,213,West,Major Market,984,81,198,117,22,11,84,33,198,Leaves,Herbal Tea,Chamomile,California,70,110,80,180,Decaf,4
2012-11-01T00:00:00,213,West,Major Market,1272,225,490,265,69,22,174,91,490,Leaves,Herbal Tea,Lemon,California,210,240,160,450,Decaf,14
2012-11-01T00:00:00,213,West,Major Market,930,118,290,172,33,11,128,44,290,Leaves,Tea,Darjeeling,California,80,130,110,210,Regular,18
2013-11-01T00:00:00,213,West,Major Market,1691,228,532,304,75,-63,292,107,567,Beans,Espresso,Decaf Espresso,California,220,290,190,510,Decaf,102
2013-11-01T00:00:00,213,West,Major Market,2580,249,623,374,87,-62,349,139,664,Beans,Coffee,Colombian,California,290,450,310,740,Regular,39
2012-12-01T00:00:00,214,South,Major Market,601,54,133,79,15,12,52,27,133,Beans,Espresso,Decaf Espresso,Texas,40,60,40,100,Decaf,12
2012-12-01T00:00:00,214,South,Major Market,435,41,101,60,13,23,24,36,101,Leaves,Herbal Tea,Lemon,Texas,30,60,30,90,Decaf,-6
2012-10-01T00:00:00,214,South,Major Market,541,39,90,51,12,13,26,25,90,Beans,Coffee,Decaf Irish Cream,Texas,40,90,80,130,Decaf,-54
2012-10-01T00:00:00,216,Central,Major Market,503,51,122,71,46,30,-5,76,122,Beans,Coffee,Decaf Irish Cream,Ohio,40,70,30,110,Decaf,-35
2012-10-01T00:00:00,217,Central,Major Market,580,76,187,111,21,12,78,33,187,Leaves,Tea,Darjeeling,Illinois,50,80,80,130,Regular,-2
2012-11-01T00:00:00,224,Central,Major Market,1691,228,532,304,75,33,196,108,532,Beans,Espresso,Caffe Mocha,Illinois,290,390,290,680,Regular,-94
2012-11-01T00:00:00,225,South,Small Market,454,49,120,71,15,22,34,37,120,Beans,Espresso,Decaf Espresso,Louisiana,30,60,30,90,Decaf,4
2012-11-01T00:00:00,225,South,Small Market,321,53,141,88,16,23,49,39,141,Beans,Espresso,Caffe Mocha,Louisiana,40,60,30,100,Regular,19
2012-12-01T00:00:00,225,South,Small Market,863,34,85,51,9,11,31,20,85,Beans,Coffee,Decaf Irish Cream,Louisiana,40,60,50,100,Decaf,-19
2013-12-01T00:00:00,225,South,Small Market,-1053,55,131,76,49,31,-4,79,140,Beans,Espresso,Caffe Latte,Louisiana,40,60,0,100,Regular,-4
2012-12-01T00:00:00,225,South,Small Market,466,43,106,63,13,23,27,36,106,Beans,Espresso,Decaf Espresso,Louisiana,30,50,20,80,Decaf,7
2013-12-01T00:00:00,225,South,Small Market,320,41,107,66,12,8,46,35,114,Beans,Espresso,Caffe Mocha,Louisiana,30,50,20,80,Regular,26
2013-10-01T00:00:00,225,South,Small Market,329,60,159,99,18,-5,86,41,169,Beans,Espresso,Caffe Mocha,Louisiana,30,70,70,100,Regular,16
2012-11-01T00:00:00,225,South,Small Market,834,47,115,68,13,11,44,24,115,Beans,Coffee,Colombian,Louisiana,50,80,60,130,Regular,-16
2012-10-01T00:00:00,225,South,Small Market,851,48,118,70,13,12,45,25,118,Beans,Coffee,Decaf Irish Cream,Louisiana,70,90,80,160,Decaf,-35
2012-10-01T00:00:00,225,South,Small Market,829,48,119,71,13,11,47,24,119,Beans,Coffee,Colombian,Louisiana,70,90,80,160,Regular,-33
2012-10-01T00:00:00,225,South,Small Market,564,103,236,133,33,13,87,46,236,Leaves,Herbal Tea,Chamomile,Louisiana,80,130,110,210,Decaf,-23
2012-12-01T00:00:00,225,South,Small Market,540,94,214,120,31,12,77,43,214,Leaves,Herbal Tea,Chamomile,Louisiana,80,110,70,190,Decaf,7
2013-10-01T00:00:00,225,South,Small Market,593,79,177,98,30,18,50,64,189,Leaves,Herbal Tea,Lemon,Louisiana,60,90,60,150,Decaf,-10
2013-10-01T00:00:00,234,Central,Major Market,503,51,122,71,46,32,-7,76,130,Beans,Coffee,Decaf Irish Cream,Ohio,40,70,30,110,Decaf,-37
2013-11-01T00:00:00,234,Central,Major Market,424,46,114,68,14,7,47,36,121,Beans,Coffee,Colombian,Ohio,40,70,40,110,Regular,7
2013-12-01T00:00:00,234,Central,Major Market,424,54,127,73,17,13,43,44,135,Beans,Coffee,Amaretto,Ohio,50,70,40,120,Regular,3
2013-11-01T00:00:00,234,Central,Major Market,411,59,138,79,19,11,49,46,147,Beans,Coffee,Amaretto,Ohio,50,80,50,130,Regular,-1
2012-10-01T00:00:00,234,Central,Major Market,788,82,205,123,27,31,65,58,205,Leaves,Tea,Darjeeling,Ohio,50,90,60,140,Regular,5
2013-11-01T00:00:00,234,Central,Major Market,1283,181,363,182,50,-27,159,75,387,Beans,Espresso,Caffe Mocha,Ohio,230,230,170,460,Regular,-11
2012-10-01T00:00:00,239,East,Major Market,547,86,202,116,28,28,60,56,202,Beans,Espresso,Decaf Espresso,Florida,70,110,90,180,Decaf,-30
2012-10-01T00:00:00,239,East,Major Market,683,96,230,134,87,29,18,116,230,Beans,Espresso,Caffe Mocha,Florida,80,130,50,210,Regular,-32
2013-11-01T00:00:00,253,West,Small Market,834,47,115,68,13,-10,65,24,123,Leaves,Herbal Tea,Lemon,Washington,40,60,40,100,Decaf,25
2013-12-01T00:00:00,253,West,Small Market,320,41,107,66,12,9,45,36,114,Leaves,Tea,Darjeeling,Washington,30,40,20,70,Regular,25
2013-12-01T00:00:00,253,West,Small Market,466,43,106,63,13,8,42,35,113,Leaves,Tea,Earl Grey,Washington,30,40,20,70,Regular,22
2012-10-01T00:00:00,253,West,Small Market,385,56,126,70,21,33,16,54,126,Beans,Espresso,Caffe Mocha,Washington,40,70,50,110,Regular,-34
2012-11-01T00:00:00,253,West,Small Market,570,22,52,30,7,12,11,19,52,Beans,Espresso,Caffe Latte,Washington,20,30,20,50,Regular,-9
2012-12-01T00:00:00,253,West,Small Market,567,24,56,32,7,12,13,19,56,Beans,Espresso,Caffe Latte,Washington,20,30,20,50,Regular,-7
2012-10-01T00:00:00,253,West,Small Market,1055,80,174,94,24,22,48,46,174,Beans,Espresso,Decaf Espresso,Washington,60,90,80,150,Decaf,-32
2012-11-01T00:00:00,253,West,Small Market,694,94,224,130,85,29,16,114,224,Beans,Coffee,Decaf Irish Cream,Washington,110,150,40,260,Decaf,-24
2012-12-01T00:00:00,253,West,Small Market,1079,80,176,96,24,21,51,45,176,Beans,Espresso,Decaf Espresso,Washington,70,100,60,170,Decaf,-9
2012-12-01T00:00:00,253,West,Small Market,461,72,176,104,23,23,58,46,176,Beans,Coffee,Colombian,Washington,80,120,80,200,Regular,-22
2013-11-01T00:00:00,253,West,Small Market,446,63,156,93,20,-1,74,43,166,Beans,Coffee,Colombian,Washington,70,110,70,180,Regular,4
2013-12-01T00:00:00,253,West,Small Market,1166,115,289,174,37,-19,156,69,308,Leaves,Herbal Tea,Chamomile,Washington,100,160,110,260,Decaf,46
2013-11-01T00:00:00,254,South,Major Market,589,50,123,73,14,-12,71,25,131,Beans,Espresso,Decaf Espresso,Texas,30,60,40,90,Decaf,31
2013-12-01T00:00:00,254,South,Major Market,959,123,302,179,34,-52,197,46,322,Beans,Espresso,Caffe Mocha,Texas,90,140,110,230,Regular,87
2012-10-01T00:00:00,262,Central,Small Market,851,48,118,70,13,12,45,25,118,Leaves,Herbal Tea,Lemon,Wisconsin,30,60,60,90,Decaf,-15
2012-11-01T00:00:00,262,Central,Small Market,391,54,121,67,20,33,14,53,121,Beans,Coffee,Amaretto,Wisconsin,50,60,20,110,Regular,-6
2013-10-01T00:00:00,262,Central,Small Market,851,48,118,70,13,-10,67,25,126,Leaves,Herbal Tea,Lemon,Wisconsin,30,60,60,90,Decaf,7
2013-11-01T00:00:00,262,Central,Small Market,391,54,121,67,20,26,21,53,129,Beans,Coffee,Amaretto,Wisconsin,50,60,20,110,Regular,1
2013-12-01T00:00:00,262,Central,Small Market,627,55,131,76,49,31,-4,79,140,Leaves,Tea,Earl Grey,Wisconsin,40,60,0,100,Regular,-4
2012-10-01T00:00:00,262,Central,Small Market,449,46,113,67,14,23,30,37,113,Leaves,Tea,Darjeeling,Wisconsin,20,50,40,70,Regular,-10
2012-11-01T00:00:00,262,Central,Small Market,856,31,78,47,8,12,27,20,78,Leaves,Herbal Tea,Lemon,Wisconsin,20,50,40,70,Decaf,-13
2012-11-01T00:00:00,262,Central,Small Market,454,49,120,71,15,23,33,38,120,Leaves,Tea,Darjeeling,Wisconsin,40,50,20,90,Regular,13
2012-12-01T00:00:00,262,Central,Small Market,466,43,106,63,13,22,28,35,106,Leaves,Tea,Darjeeling,Wisconsin,30,50,20,80,Regular,8
2013-10-01T00:00:00,262,Central,Small Market,573,22,51,29,7,7,15,19,54,Beans,Espresso,Decaf Espresso,Wisconsin,20,50,50,70,Decaf,-35
2013-10-01T00:00:00,262,Central,Small Market,449,46,113,67,14,8,45,37,120,Leaves,Tea,Darjeeling,Wisconsin,20,50,40,70,Regular,5
2013-10-01T00:00:00,262,Central,Small Market,606,60,144,84,54,30,0,84,153,Leaves,Tea,Earl Grey,Wisconsin,40,50,0,90,Regular,0
2013-12-01T00:00:00,262,Central,Small Market,466,43,106,63,13,8,42,35,113,Leaves,Tea,Darjeeling,Wisconsin,30,50,20,80,Regular,22
2012-12-01T00:00:00,262,Central,Small Market,567,24,56,32,7,12,13,19,56,Beans,Espresso,Decaf Espresso,Wisconsin,30,40,30,70,Decaf,-17
2013-11-01T00:00:00,262,Central,Small Market,321,53,141,88,16,1,71,40,150,Leaves,Herbal Tea,Chamomile,Wisconsin,50,80,50,130,Decaf,21
2012-11-01T00:00:00,262,Central,Small Market,557,77,180,103,25,27,51,52,180,Beans,Coffee,Decaf Irish Cream,Wisconsin,70,100,60,170,Decaf,-9
2012-11-01T00:00:00,262,Central,Small Market,694,94,224,130,85,29,16,114,224,Beans,Coffee,Colombian,Wisconsin,90,130,30,220,Regular,-14
2013-10-01T00:00:00,262,Central,Small Market,1055,80,174,94,24,-1,71,46,185,Beans,Espresso,Caffe Mocha,Wisconsin,110,140,120,250,Regular,-49
2013-12-01T00:00:00,262,Central,Small Market,716,105,250,145,95,20,30,125,266,Beans,Coffee,Colombian,Wisconsin,100,140,30,240,Regular,0
2013-12-01T00:00:00,262,Central,Small Market,1079,80,176,96,24,-2,74,46,188,Beans,Espresso,Caffe Mocha,Wisconsin,100,120,80,220,Regular,-6
2013-10-01T00:00:00,281,South,Major Market,541,39,90,51,12,0,39,25,96,Beans,Coffee,Decaf Irish Cream,Texas,40,90,80,130,Decaf,-41
2012-10-01T00:00:00,303,Central,Major Market,503,51,122,71,46,30,-5,76,122,Leaves,Herbal Tea,Lemon,Colorado,30,60,30,90,Decaf,-35
2012-12-01T00:00:00,303,Central,Major Market,424,54,127,73,17,27,29,44,127,Leaves,Herbal Tea,Mint,Colorado,50,60,30,110,Decaf,-1
2012-10-01T00:00:00,303,Central,Major Market,404,54,120,66,20,33,13,53,120,Leaves,Tea,Darjeeling,Colorado,30,50,30,80,Regular,-17
2012-10-01T00:00:00,303,Central,Major Market,1037,54,118,64,16,21,27,37,118,Leaves,Tea,Earl Grey,Colorado,30,50,40,80,Regular,-13
2012-12-01T00:00:00,303,Central,Major Market,422,46,103,57,17,34,6,51,103,Leaves,Tea,Darjeeling,Colorado,30,50,10,80,Regular,-4
2012-12-01T00:00:00,303,Central,Major Market,1054,53,116,63,16,21,26,37,116,Leaves,Tea,Earl Grey,Colorado,40,50,20,90,Regular,6
2013-10-01T00:00:00,303,Central,Major Market,541,39,90,51,12,-1,40,24,96,Beans,Coffee,Colombian,Colorado,30,50,50,80,Regular,-10
2013-12-01T00:00:00,303,Central,Major Market,422,46,103,57,17,31,9,51,110,Leaves,Tea,Darjeeling,Colorado,30,50,10,80,Regular,-1
2012-11-01T00:00:00,303,Central,Major Market,509,52,125,73,47,30,-4,77,125,Leaves,Herbal Tea,Lemon,Colorado,40,70,10,110,Decaf,-14
2012-10-01T00:00:00,303,Central,Major Market,650,72,182,110,23,31,56,54,182,Beans,Espresso,Decaf Espresso,Colorado,100,160,130,260,Decaf,-74
2012-10-01T00:00:00,303,Central,Major Market,580,76,187,111,21,11,79,32,187,Beans,Espresso,Caffe Mocha,Colorado,100,180,170,280,Regular,-91
2012-11-01T00:00:00,303,Central,Major Market,659,75,189,114,24,32,58,56,189,Beans,Espresso,Decaf Espresso,Colorado,90,150,100,240,Decaf,-42
2012-11-01T00:00:00,303,Central,Major Market,589,50,123,73,14,11,48,25,123,Beans,Espresso,Caffe Mocha,Colorado,60,90,70,150,Regular,-22
2012-12-01T00:00:00,303,Central,Major Market,1319,153,306,153,42,24,87,66,306,Leaves,Herbal Tea,Chamomile,Colorado,140,140,80,280,Decaf,7
2013-11-01T00:00:00,303,Central,Major Market,589,50,123,73,14,-12,71,25,131,Beans,Espresso,Caffe Mocha,Colorado,60,90,70,150,Regular,1
2013-12-01T00:00:00,303,Central,Major Market,959,123,302,179,34,-54,199,45,322,Beans,Coffee,Amaretto,Colorado,120,170,130,290,Regular,69
2013-12-01T00:00:00,305,East,Major Market,403,65,145,80,24,22,34,57,155,Leaves,Herbal Tea,Lemon,Florida,40,60,20,100,Decaf,14
2012-10-01T00:00:00,305,East,Major Market,1055,80,174,94,24,22,48,46,174,Leaves,Herbal Tea,Mint,Florida,40,50,40,90,Decaf,8
2012-12-01T00:00:00,305,East,Major Market,716,105,250,145,95,29,21,124,250,Beans,Espresso,Caffe Mocha,Florida,100,140,30,240,Regular,-9
2013-12-01T00:00:00,305,East,Major Market,716,105,250,145,95,19,31,124,266,Beans,Espresso,Caffe Mocha,Florida,100,140,30,240,Regular,1
2012-12-01T00:00:00,309,Central,Major Market,601,54,133,79,15,11,53,26,133,Leaves,Tea,Darjeeling,Illinois,40,70,50,110,Regular,3
2012-12-01T00:00:00,309,Central,Major Market,959,123,302,179,34,12,133,46,302,Leaves,Herbal Tea,Chamomile,Illinois,110,170,130,280,Decaf,3
2013-11-01T00:00:00,309,Central,Major Market,659,75,189,114,24,2,88,55,201,Leaves,Tea,Earl Grey,Illinois,60,90,50,150,Regular,38
2013-11-01T00:00:00,312,Central,Major Market,536,40,92,52,13,-1,40,25,98,Leaves,Herbal Tea,Lemon,Illinois,30,50,30,80,Decaf,10
2013-12-01T00:00:00,312,Central,Major Market,531,43,99,56,14,-1,43,27,106,Leaves,Herbal Tea,Lemon,Illinois,40,50,30,90,Decaf,13
2013-10-01T00:00:00,312,Central,Major Market,541,39,90,51,12,-1,40,24,96,Leaves,Herbal Tea,Lemon,Illinois,20,40,40,60,Decaf,0
2012-10-01T00:00:00,312,Central,Major Market,1755,239,478,239,66,24,149,90,478,Beans,Espresso,Decaf Espresso,Illinois,340,370,300,710,Decaf,-151
2012-11-01T00:00:00,312,Central,Major Market,930,118,290,172,33,12,127,45,290,Leaves,Herbal Tea,Chamomile,Illinois,110,150,110,260,Decaf,17
2013-10-01T00:00:00,312,Central,Major Market,1662,257,598,341,84,-75,332,117,637,Beans,Espresso,Caffe Mocha,Illinois,370,520,420,890,Regular,-88
2013-12-01T00:00:00,312,Central,Major Market,830,127,312,185,40,-36,181,63,332,Beans,Coffee,Decaf Irish Cream,Illinois,120,180,130,300,Decaf,51
2013-12-01T00:00:00,312,Central,Major Market,1191,224,534,310,73,-51,288,116,569,Beans,Coffee,Colombian,Illinois,220,300,190,520,Regular,98
2013-12-01T00:00:00,312,Central,Major Market,1003,86,210,124,24,-31,131,36,224,Leaves,Herbal Tea,Mint,Illinois,80,110,80,190,Decaf,51
2012-11-01T00:00:00,314,Central,Small Market,836,33,81,48,9,12,27,21,81,Beans,Espresso,Decaf Espresso,Missouri,40,60,50,100,Decaf,-23
2012-12-01T00:00:00,314,Central,Small Market,844,31,77,46,8,11,27,19,77,Beans,Espresso,Decaf Espresso,Missouri,30,60,50,90,Decaf,-23
2013-12-01T00:00:00,314,Central,Small Market,335,49,118,69,44,32,-7,74,126,Leaves,Herbal Tea,Chamomile,Missouri,40,60,0,100,Decaf,-7
2013-11-01T00:00:00,314,Central,Small Market,325,44,106,62,40,34,-12,70,113,Leaves,Herbal Tea,Chamomile,Missouri,40,50,0,90,Decaf,-12
2012-11-01T00:00:00,314,Central,Small Market,243,33,74,41,12,33,-4,45,74,Leaves,Tea,Green Tea,Missouri,20,40,0,60,Regular,-4
2013-10-01T00:00:00,314,Central,Small Market,244,39,92,53,12,22,19,40,98,Leaves,Tea,Darjeeling,Missouri,20,40,30,60,Regular,-11
2013-11-01T00:00:00,314,Central,Small Market,1804,82,122,40,25,28,-13,49,130,Leaves,Herbal Tea,Lemon,Missouri,70,40,0,110,Decaf,-13
2013-11-01T00:00:00,314,Central,Small Market,243,33,74,41,12,35,-6,45,79,Leaves,Tea,Green Tea,Missouri,20,40,0,60,Regular,-6
2013-12-01T00:00:00,314,Central,Small Market,256,38,89,51,12,23,16,40,95,Leaves,Tea,Darjeeling,Missouri,30,40,10,70,Regular,6
2012-10-01T00:00:00,314,Central,Small Market,240,34,77,43,12,34,-3,46,77,Leaves,Tea,Green Tea,Missouri,10,30,10,40,Regular,-13
2013-10-01T00:00:00,314,Central,Small Market,240,34,77,43,12,35,-4,46,82,Leaves,Tea,Green Tea,Missouri,10,30,10,40,Regular,-14
2012-11-01T00:00:00,314,Central,Small Market,1060,69,150,81,21,22,38,43,150,Beans,Coffee,Decaf Irish Cream,Missouri,60,80,40,140,Decaf,-2
2012-10-01T00:00:00,314,Central,Small Market,881,40,99,59,11,12,36,23,99,Beans,Espresso,Caffe Mocha,Missouri,50,90,90,140,Regular,-54
2012-11-01T00:00:00,314,Central,Small Market,885,54,132,78,15,12,51,27,132,Beans,Espresso,Caffe Mocha,Missouri,60,100,80,160,Regular,-29
2012-12-01T00:00:00,314,Central,Small Market,898,50,123,73,14,11,48,25,123,Beans,Espresso,Caffe Mocha,Missouri,60,90,70,150,Regular,-22
2012-10-01T00:00:00,315,East,Major Market,2548,260,650,390,91,52,247,143,650,Beans,Coffee,Colombian,New York,210,330,230,540,Regular,17
2012-10-01T00:00:00,315,East,Major Market,4360,239,164,-75,74,21,-170,95,164,Leaves,Herbal Tea,Mint,New York,130,-50,-100,80,Decaf,-70
2012-11-01T00:00:00,315,East,Major Market,930,118,290,172,33,12,127,45,290,Leaves,Tea,Earl Grey,New York,120,170,130,290,Regular,-3
2013-12-01T00:00:00,315,East,Major Market,2642,279,699,420,97,-79,402,149,745,Beans,Coffee,Colombian,New York,250,370,250,620,Regular,152
2012-10-01T00:00:00,318,South,Small Market,-762,60,144,84,54,29,1,83,144,Beans,Espresso,Caffe Latte,Louisiana,30,60,10,90,Regular,-9
2013-11-01T00:00:00,318,South,Small Market,321,53,141,88,16,-1,73,39,150,Beans,Espresso,Caffe Mocha,Louisiana,40,60,30,100,Regular,43
2013-12-01T00:00:00,318,South,Small Market,466,43,106,63,13,10,40,36,113,Beans,Espresso,Decaf Espresso,Louisiana,30,50,20,80,Decaf,20
2012-10-01T00:00:00,318,South,Small Market,449,46,113,67,14,23,30,37,113,Beans,Espresso,Decaf Espresso,Louisiana,20,40,40,60,Decaf,-10
2013-10-01T00:00:00,318,South,Small Market,449,46,113,67,14,8,45,37,120,Beans,Espresso,Decaf Espresso,Louisiana,20,40,40,60,Decaf,5
2013-11-01T00:00:00,318,South,Small Market,-906,61,147,86,55,30,1,85,157,Beans,Espresso,Caffe Latte,Louisiana,40,70,10,110,Regular,-9
2013-11-01T00:00:00,318,South,Small Market,834,47,115,68,13,-10,65,24,123,Beans,Coffee,Colombian,Louisiana,50,80,60,130,Regular,5
2013-12-01T00:00:00,318,South,Small Market,619,68,153,85,25,21,39,59,163,Leaves,Herbal Tea,Lemon,Louisiana,60,80,30,140,Decaf,9
2012-12-01T00:00:00,318,South,Small Market,845,49,120,71,13,12,46,25,120,Beans,Coffee,Colombian,Louisiana,50,90,70,140,Regular,-24
2013-10-01T00:00:00,318,South,Small Market,564,103,236,133,33,-29,129,46,251,Leaves,Herbal Tea,Chamomile,Louisiana,80,130,110,210,Decaf,19
2012-10-01T00:00:00,319,Central,Small Market,800,23,58,35,6,11,18,17,58,Beans,Espresso,Caffe Mocha,Iowa,20,50,50,70,Regular,-32
2012-11-01T00:00:00,319,Central,Small Market,1784,245,545,300,93,34,173,127,545,Leaves,Tea,Earl Grey,Iowa,200,250,130,450,Regular,43
2012-12-01T00:00:00,319,Central,Small Market,594,10,24,14,3,12,-1,15,24,Beans,Coffee,Decaf Irish Cream,Iowa,0,20,10,20,Decaf,-11
2012-12-01T00:00:00,319,Central,Small Market,830,127,312,185,40,22,123,62,312,Leaves,Herbal Tea,Lemon,Iowa,120,170,120,290,Decaf,3
2013-10-01T00:00:00,319,Central,Small Market,1662,257,598,341,84,-75,332,117,637,Leaves,Herbal Tea,Chamomile,Iowa,200,280,210,480,Decaf,122
2013-11-01T00:00:00,319,Central,Small Market,596,10,23,13,3,14,-4,16,25,Beans,Coffee,Decaf Irish Cream,Iowa,0,20,10,20,Decaf,-14
2013-12-01T00:00:00,321,East,Major Market,863,34,85,51,9,-3,45,21,91,Leaves,Tea,Green Tea,Florida,30,50,40,80,Regular,5
2013-12-01T00:00:00,321,East,Major Market,882,30,75,45,8,-2,39,19,80,Leaves,Tea,Darjeeling,Florida,30,40,30,70,Regular,9
2013-10-01T00:00:00,321,East,Major Market,547,86,202,116,28,-1,89,56,215,Beans,Espresso,Decaf Espresso,Florida,70,110,90,180,Decaf,-1
2013-11-01T00:00:00,323,West,Major Market,536,40,92,52,13,-1,40,25,98,Leaves,Herbal Tea,Mint,California,30,50,30,80,Decaf,10
2013-12-01T00:00:00,323,West,Major Market,531,43,99,56,14,-1,43,27,106,Leaves,Herbal Tea,Mint,California,40,50,30,90,Decaf,13
2013-12-01T00:00:00,323,West,Major Market,959,123,302,179,34,-54,199,45,322,Leaves,Tea,Darjeeling,California,90,130,110,220,Regular,89
2013-12-01T00:00:00,325,South,Major Market,424,54,127,73,17,14,42,45,135,Leaves,Herbal Tea,Chamomile,Texas,50,60,30,110,Decaf,12
2013-10-01T00:00:00,325,South,Major Market,405,52,123,71,17,15,39,45,131,Leaves,Herbal Tea,Chamomile,Texas,30,80,70,110,Decaf,-31
2013-12-01T00:00:00,330,Central,Major Market,435,41,101,60,13,11,36,36,108,Beans,Coffee,Colombian,Ohio,40,50,20,90,Regular,16
2012-12-01T00:00:00,330,Central,Major Market,870,33,82,49,9,11,29,20,82,Leaves,Herbal Tea,Lemon,Ohio,30,40,30,70,Decaf,-1
2012-11-01T00:00:00,330,Central,Major Market,411,59,138,79,19,27,33,46,138,Beans,Coffee,Amaretto,Ohio,50,80,50,130,Regular,-17
2012-11-01T00:00:00,330,Central,Major Market,798,78,197,119,25,32,62,57,197,Leaves,Tea,Darjeeling,Ohio,60,100,60,160,Regular,2
2013-11-01T00:00:00,337,South,Small Market,454,49,120,71,15,6,50,37,128,Beans,Espresso,Decaf Espresso,Louisiana,30,60,30,90,Decaf,20
2013-12-01T00:00:00,337,South,Small Market,863,34,85,51,9,-4,46,20,91,Beans,Coffee,Decaf Irish Cream,Louisiana,40,60,50,100,Decaf,-4
2012-11-01T00:00:00,337,South,Small Market,552,101,231,130,33,12,85,45,231,Leaves,Herbal Tea,Chamomile,Louisiana,90,120,80,210,Decaf,5
2012-11-01T00:00:00,337,South,Small Market,601,82,184,102,31,33,38,64,184,Leaves,Herbal Tea,Lemon,Louisiana,70,100,40,170,Decaf,-2
2013-10-01T00:00:00,337,South,Small Market,829,48,119,71,13,-12,70,24,127,Beans,Coffee,Colombian,Louisiana,70,90,80,160,Regular,-10
2013-11-01T00:00:00,337,South,Small Market,601,82,184,102,31,15,56,64,196,Leaves,Herbal Tea,Lemon,Louisiana,70,100,40,170,Decaf,16
2012-11-01T00:00:00,339,East,Major Market,862,36,88,52,10,11,31,21,88,Leaves,Tea,Darjeeling,Massachusetts,30,60,40,90,Regular,-9
2013-11-01T00:00:00,339,East,Major Market,554,52,120,68,47,33,-12,76,128,Beans,Espresso,Caffe Mocha,Massachusetts,50,60,0,110,Regular,-12
2012-12-01T00:00:00,339,East,Major Market,571,47,99,52,42,30,-20,72,99,Beans,Espresso,Caffe Mocha,Massachusetts,40,50,-10,90,Regular,-10
2013-10-01T00:00:00,339,East,Major Market,404,54,120,66,20,27,19,53,128,Leaves,Herbal Tea,Lemon,Massachusetts,30,30,20,60,Decaf,-1
2012-11-01T00:00:00,347,East,Major Market,2580,249,623,374,87,51,236,138,623,Beans,Coffee,Colombian,New York,220,340,230,560,Regular,6
2012-11-01T00:00:00,347,East,Major Market,3385,121,61,-60,109,33,-202,142,61,Beans,Espresso,Caffe Mocha,New York,110,-60,-190,50,Regular,-12
2013-11-01T00:00:00,351,East,Major Market,862,36,88,52,10,-4,46,21,94,Leaves,Tea,Darjeeling,Massachusetts,30,60,40,90,Regular,6
2012-11-01T00:00:00,351,East,Major Market,482,32,80,48,8,11,29,19,80,Leaves,Tea,Green Tea,Massachusetts,30,50,40,80,Regular,-11
2012-12-01T00:00:00,351,East,Major Market,-3534,67,510,443,22,31,390,53,510,Beans,Coffee,Colombian,Massachusetts,60,390,360,450,Regular,30
2012-12-01T00:00:00,351,East,Major Market,1319,153,306,153,42,24,87,66,306,Beans,Espresso,Regular Espresso,Massachusetts,150,140,80,290,Regular,7
2013-12-01T00:00:00,351,East,Major Market,-3534,67,510,443,22,-158,579,53,543,Beans,Coffee,Colombian,Massachusetts,60,390,360,450,Regular,219
2012-11-01T00:00:00,352,East,Major Market,875,28,70,42,7,12,23,19,70,Leaves,Tea,Darjeeling,Florida,20,50,40,70,Regular,-17
2013-11-01T00:00:00,352,East,Major Market,875,28,70,42,7,1,34,19,75,Leaves,Tea,Darjeeling,Florida,20,50,40,70,Regular,-6
2012-12-01T00:00:00,360,West,Small Market,627,55,131,76,49,30,-3,79,131,Leaves,Tea,Green Tea,Washington,40,50,-10,90,Regular,7
2012-10-01T00:00:00,360,West,Small Market,449,46,113,67,14,22,31,36,113,Leaves,Tea,Earl Grey,Washington,20,30,30,50,Regular,1
2013-10-01T00:00:00,360,West,Small Market,1055,80,174,94,24,-1,71,46,185,Beans,Espresso,Decaf Espresso,Washington,60,90,80,150,Decaf,-9
2013-10-01T00:00:00,360,West,Small Market,438,68,167,99,21,-5,83,43,178,Beans,Coffee,Colombian,Washington,90,140,110,230,Regular,-27
2013-10-01T00:00:00,360,West,Small Market,1119,125,313,188,41,-24,171,73,334,Leaves,Herbal Tea,Chamomile,Washington,90,160,130,250,Decaf,41
2013-12-01T00:00:00,360,West,Small Market,1079,80,176,96,24,-4,76,45,188,Beans,Espresso,Decaf Espresso,Washington,70,100,60,170,Decaf,16
2013-12-01T00:00:00,360,West,Small Market,461,72,176,104,23,-5,86,46,188,Beans,Coffee,Colombian,Washington,80,120,80,200,Regular,6
2013-12-01T00:00:00,361,South,Major Market,-1239,67,168,101,22,9,70,54,179,Beans,Espresso,Caffe Latte,Texas,50,70,30,120,Regular,40
2012-10-01T00:00:00,386,East,Major Market,573,22,51,29,7,12,10,19,51,Leaves,Herbal Tea,Chamomile,Florida,0,20,20,20,Decaf,-10
2013-12-01T00:00:00,386,East,Major Market,575,83,195,112,27,-1,86,54,208,Beans,Espresso,Decaf Espresso,Florida,80,110,70,190,Decaf,16
2013-10-01T00:00:00,405,South,Small Market,859,27,66,39,7,1,31,18,70,Beans,Coffee,Decaf Irish Cream,Oklahoma,30,60,60,90,Decaf,-29
2012-10-01T00:00:00,405,South,Small Market,385,56,126,70,21,33,16,54,126,Leaves,Herbal Tea,Chamomile,Oklahoma,40,70,50,110,Decaf,-34
2012-12-01T00:00:00,405,South,Small Market,403,65,145,80,24,34,22,58,145,Leaves,Herbal Tea,Chamomile,Oklahoma,60,70,20,130,Decaf,2
2013-12-01T00:00:00,405,South,Small Market,403,65,145,80,24,23,33,58,155,Leaves,Herbal Tea,Chamomile,Oklahoma,60,70,20,130,Decaf,13
2012-10-01T00:00:00,405,South,Small Market,480,21,53,32,5,12,15,17,53,Beans,Espresso,Caffe Mocha,Oklahoma,0,30,30,30,Regular,-15
2012-10-01T00:00:00,405,South,Small Market,788,82,205,123,27,31,65,58,205,Beans,Espresso,Decaf Espresso,Oklahoma,50,80,60,130,Decaf,5
2012-10-01T00:00:00,405,South,Small Market,-1785,91,218,127,28,23,76,51,218,Beans,Espresso,Caffe Latte,Oklahoma,50,80,70,130,Regular,6
2013-10-01T00:00:00,405,South,Small Market,788,82,205,123,27,0,96,58,218,Beans,Espresso,Decaf Espresso,Oklahoma,50,80,60,130,Decaf,36
2013-10-01T00:00:00,405,South,Small Market,-1785,91,218,127,28,-14,113,51,232,Beans,Espresso,Caffe Latte,Oklahoma,50,80,70,130,Regular,43
2012-10-01T00:00:00,405,South,Small Market,683,96,230,134,87,30,17,117,230,Leaves,Herbal Tea,Lemon,Oklahoma,80,120,40,200,Decaf,-23
2012-12-01T00:00:00,405,South,Small Market,817,88,221,133,29,32,72,61,221,Beans,Espresso,Decaf Espresso,Oklahoma,60,110,60,170,Decaf,12
2012-12-01T00:00:00,405,South,Small Market,551,81,185,104,26,12,66,38,185,Beans,Coffee,Colombian,Oklahoma,90,130,100,220,Regular,-34
2013-11-01T00:00:00,405,South,Small Market,-2003,102,245,143,31,-20,132,54,261,Beans,Espresso,Caffe Latte,Oklahoma,80,100,60,180,Regular,72
2013-11-01T00:00:00,405,South,Small Market,694,94,224,130,85,23,22,115,239,Leaves,Herbal Tea,Lemon,Oklahoma,80,120,20,200,Decaf,2
2013-12-01T00:00:00,407,East,Major Market,1079,80,176,96,24,-2,74,46,188,Leaves,Herbal Tea,Mint,Florida,60,60,30,120,Decaf,44
2012-11-01T00:00:00,407,East,Major Market,391,54,121,67,20,34,13,54,121,Leaves,Herbal Tea,Lemon,Florida,40,40,10,80,Decaf,3
2012-10-01T00:00:00,407,East,Major Market,788,82,205,123,27,32,64,59,205,Beans,Coffee,Colombian,Florida,60,110,90,170,Regular,-26
2012-12-01T00:00:00,407,East,Major Market,575,83,195,112,27,27,58,54,195,Beans,Espresso,Decaf Espresso,Florida,80,110,70,190,Decaf,-12
2013-12-01T00:00:00,407,East,Major Market,817,88,221,133,29,-4,108,60,236,Beans,Coffee,Colombian,Florida,70,120,80,190,Regular,28
2013-12-01T00:00:00,408,West,Major Market,601,54,133,79,15,-15,79,26,142,Leaves,Tea,Earl Grey,California,30,60,50,90,Regular,29
2012-10-01T00:00:00,409,South,Major Market,419,43,107,64,13,23,28,36,107,Leaves,Herbal Tea,Lemon,Texas,30,60,50,90,Decaf,-22
2012-11-01T00:00:00,409,South,Major Market,930,118,290,172,33,12,127,45,290,Beans,Espresso,Caffe Mocha,Texas,90,130,100,220,Regular,27
2013-12-01T00:00:00,409,South,Major Market,1321,241,525,284,74,-69,279,96,559,Beans,Coffee,Colombian,Texas,280,340,240,620,Regular,39
2012-10-01T00:00:00,413,East,Major Market,480,21,53,32,5,12,15,17,53,Leaves,Tea,Green Tea,Massachusetts,20,30,30,50,Regular,-15
2012-10-01T00:00:00,414,Central,Small Market,329,60,159,99,18,24,57,42,159,Leaves,Herbal Tea,Chamomile,Wisconsin,40,80,80,120,Decaf,-23
2013-10-01T00:00:00,414,Central,Small Market,385,56,126,70,21,27,22,55,134,Beans,Coffee,Amaretto,Wisconsin,40,80,50,120,Regular,-28
2013-10-01T00:00:00,414,Central,Small Market,683,96,230,134,87,20,27,116,245,Beans,Coffee,Colombian,Wisconsin,90,140,60,230,Regular,-33
2013-12-01T00:00:00,414,Central,Small Market,575,83,195,112,27,0,85,55,208,Beans,Coffee,Decaf Irish Cream,Wisconsin,80,110,70,190,Decaf,15
2012-12-01T00:00:00,415,West,Major Market,1321,241,525,284,74,22,188,96,525,Leaves,Herbal Tea,Lemon,California,220,260,170,480,Decaf,18
2013-10-01T00:00:00,415,West,Major Market,1662,257,598,341,84,-77,334,116,637,Beans,Espresso,Decaf Espresso,California,230,320,240,550,Decaf,94
2012-12-01T00:00:00,417,Central,Small Market,335,49,118,69,44,30,-5,74,118,Leaves,Herbal Tea,Chamomile,Missouri,40,60,0,100,Decaf,-5
2013-12-01T00:00:00,417,Central,Small Market,1898,92,160,68,28,16,24,52,171,Leaves,Herbal Tea,Lemon,Missouri,80,60,20,140,Decaf,4
2012-11-01T00:00:00,417,Central,Small Market,248,35,82,47,11,27,9,38,82,Leaves,Tea,Darjeeling,Missouri,20,40,10,60,Regular,-1
2013-10-01T00:00:00,417,Central,Small Market,833,32,79,47,8,-3,42,19,84,Beans,Espresso,Decaf Espresso,Missouri,30,80,80,110,Decaf,-38
2013-11-01T00:00:00,417,Central,Small Market,1060,69,150,81,21,4,56,43,160,Beans,Coffee,Decaf Irish Cream,Missouri,60,80,40,140,Decaf,16
2012-10-01T00:00:00,417,Central,Small Market,209,25,56,31,9,33,-11,42,56,Leaves,Tea,Earl Grey,Missouri,10,20,0,30,Regular,-11
2013-10-01T00:00:00,417,Central,Small Market,1698,86,109,23,26,36,-39,49,116,Leaves,Herbal Tea,Lemon,Missouri,60,20,10,80,Decaf,-49
2013-11-01T00:00:00,419,Central,Major Market,862,36,88,52,10,-3,45,22,94,Leaves,Herbal Tea,Lemon,Ohio,30,50,40,80,Decaf,5
2012-12-01T00:00:00,419,Central,Major Market,521,47,112,65,42,29,-6,71,112,Beans,Coffee,Decaf Irish Cream,Ohio,40,70,10,110,Decaf,-16
2012-11-01T00:00:00,419,Central,Major Market,410,55,124,69,20,33,16,53,124,Beans,Espresso,Decaf Espresso,Ohio,70,80,40,150,Decaf,-24
2013-12-01T00:00:00,419,Central,Major Market,422,46,103,57,17,31,9,51,110,Beans,Espresso,Decaf Espresso,Ohio,50,80,40,130,Decaf,-31
2012-11-01T00:00:00,419,Central,Major Market,666,102,245,143,31,23,89,54,245,Leaves,Tea,Earl Grey,Ohio,80,120,70,200,Regular,19
2013-10-01T00:00:00,419,Central,Major Market,404,54,120,66,20,28,18,54,128,Beans,Espresso,Decaf Espresso,Ohio,70,100,70,170,Decaf,-52
2013-10-01T00:00:00,419,Central,Major Market,788,82,205,123,27,0,96,58,218,Leaves,Tea,Darjeeling,Ohio,50,90,60,140,Regular,36
2013-10-01T00:00:00,419,Central,Major Market,656,91,218,127,28,-14,113,51,232,Leaves,Tea,Earl Grey,Ohio,50,100,80,150,Regular,33
2012-10-01T00:00:00,425,West,Small Market,829,48,119,71,13,11,47,24,119,Leaves,Herbal Tea,Lemon,Washington,30,60,60,90,Decaf,-13
2012-11-01T00:00:00,425,West,Small Market,391,54,121,67,20,34,13,54,121,Beans,Espresso,Caffe Mocha,Washington,50,60,20,110,Regular,-7
2013-10-01T00:00:00,425,West,Small Market,329,60,159,99,18,-4,85,42,169,Leaves,Tea,Darjeeling,Washington,20,50,40,70,Regular,45
2012-11-01T00:00:00,425,West,Small Market,321,53,141,88,16,23,49,39,141,Leaves,Tea,Darjeeling,Washington,30,70,50,100,Regular,-1
2012-12-01T00:00:00,425,West,Small Market,845,49,120,71,13,12,46,25,120,Leaves,Herbal Tea,Lemon,Washington,40,70,50,110,Decaf,-4
2013-10-01T00:00:00,425,West,Small Market,385,56,126,70,21,25,24,54,134,Beans,Espresso,Caffe Mocha,Washington,40,70,50,110,Regular,-26
2013-12-01T00:00:00,425,West,Small Market,845,49,120,71,13,-10,68,25,128,Leaves,Herbal Tea,Lemon,Washington,40,70,50,110,Decaf,18
2013-11-01T00:00:00,425,West,Small Market,570,22,52,30,7,7,16,19,55,Beans,Espresso,Caffe Latte,Washington,20,30,20,50,Regular,-4
2013-11-01T00:00:00,425,West,Small Market,1063,75,164,89,23,-1,67,44,175,Beans,Espresso,Decaf Espresso,Washington,70,80,40,150,Decaf,27
2012-10-01T00:00:00,425,West,Small Market,683,96,230,134,87,30,17,117,230,Beans,Coffee,Decaf Irish Cream,Washington,140,190,100,330,Decaf,-83
2012-11-01T00:00:00,425,West,Small Market,446,63,156,93,20,23,50,43,156,Beans,Coffee,Colombian,Washington,70,110,70,180,Regular,-20
2013-10-01T00:00:00,430,South,Major Market,419,43,107,64,13,9,42,36,114,Leaves,Herbal Tea,Lemon,Texas,30,60,50,90,Decaf,-8
2013-12-01T00:00:00,430,South,Major Market,601,54,133,79,15,-13,77,27,142,Beans,Espresso,Decaf Espresso,Texas,40,60,40,100,Decaf,37
2013-12-01T00:00:00,430,South,Major Market,435,41,101,60,13,11,36,36,108,Leaves,Herbal Tea,Lemon,Texas,30,60,30,90,Decaf,6
2013-10-01T00:00:00,432,South,Major Market,580,76,187,111,21,-26,116,33,199,Beans,Espresso,Decaf Espresso,Texas,40,80,80,120,Decaf,36
2013-10-01T00:00:00,432,South,Major Market,1246,239,520,281,74,-68,275,96,554,Beans,Coffee,Colombian,Texas,350,420,340,770,Regular,-65
2013-11-01T00:00:00,432,South,Major Market,1272,225,490,265,69,-62,258,91,522,Beans,Coffee,Colombian,Texas,260,320,230,580,Regular,28
2012-10-01T00:00:00,435,West,Small Market,881,40,99,59,11,11,37,22,99,Beans,Espresso,Decaf Espresso,Utah,20,60,60,80,Decaf,-23
2012-11-01T00:00:00,435,West,Small Market,452,43,109,66,14,32,20,46,109,Leaves,Herbal Tea,Lemon,Utah,40,60,30,100,Decaf,-10
2012-12-01T00:00:00,435,West,Small Market,1898,92,160,68,28,23,17,51,160,Leaves,Herbal Tea,Mint,Utah,80,60,20,140,Decaf,-3
2013-10-01T00:00:00,435,West,Small Market,881,40,99,59,11,-7,55,22,106,Beans,Espresso,Decaf Espresso,Utah,20,60,60,80,Decaf,-5
2013-11-01T00:00:00,435,West,Small Market,316,46,113,67,14,8,45,37,120,Leaves,Herbal Tea,Chamomile,Utah,40,60,30,100,Decaf,15
2013-11-01T00:00:00,435,West,Small Market,452,43,109,66,14,22,30,46,116,Leaves,Herbal Tea,Lemon,Utah,40,60,30,100,Decaf,0
2013-12-01T00:00:00,435,West,Small Market,1898,92,160,68,28,15,25,51,171,Leaves,Herbal Tea,Mint,Utah,80,60,20,140,Decaf,5
2012-12-01T00:00:00,435,West,Small Market,335,49,118,69,44,29,-4,73,118,Leaves,Tea,Darjeeling,Utah,30,50,0,80,Regular,-4
2013-12-01T00:00:00,435,West,Small Market,335,49,118,69,44,31,-6,73,126,Leaves,Tea,Darjeeling,Utah,30,50,0,80,Regular,-6
2012-11-01T00:00:00,435,West,Small Market,836,33,81,48,9,12,27,21,81,Beans,Espresso,Caffe Latte,Utah,30,40,30,70,Regular,-3
2012-11-01T00:00:00,435,West,Small Market,325,44,106,62,40,29,-7,69,106,Leaves,Tea,Darjeeling,Utah,30,40,-10,70,Regular,3
2012-12-01T00:00:00,435,West,Small Market,844,31,77,46,8,12,26,20,77,Beans,Espresso,Caffe Latte,Utah,30,40,30,70,Regular,-4
2013-10-01T00:00:00,435,West,Small Market,833,32,79,47,8,-3,42,19,84,Beans,Espresso,Caffe Latte,Utah,20,40,40,60,Regular,2
2013-10-01T00:00:00,435,West,Small Market,320,45,109,64,41,32,-9,70,116,Leaves,Tea,Darjeeling,Utah,10,40,20,50,Regular,-29
2013-11-01T00:00:00,435,West,Small Market,836,33,81,48,9,-1,40,21,86,Beans,Espresso,Caffe Latte,Utah,30,40,30,70,Regular,10
2013-11-01T00:00:00,435,West,Small Market,1804,82,122,40,25,27,-12,48,130,Leaves,Herbal Tea,Mint,Utah,70,40,0,110,Decaf,-12
2013-11-01T00:00:00,435,West,Small Market,325,44,106,62,40,32,-10,69,113,Leaves,Tea,Darjeeling,Utah,30,40,-10,70,Regular,0
2013-12-01T00:00:00,435,West,Small Market,844,31,77,46,8,-1,39,20,82,Beans,Espresso,Caffe Latte,Utah,30,40,30,70,Regular,9
2013-12-01T00:00:00,435,West,Small Market,256,38,89,51,12,21,18,39,95,Leaves,Tea,Earl Grey,Utah,20,40,10,60,Regular,8
2012-10-01T00:00:00,435,West,Small Market,447,45,114,69,14,32,23,46,114,Leaves,Herbal Tea,Lemon,Utah,20,70,60,90,Decaf,-37
2012-11-01T00:00:00,435,West,Small Market,885,54,132,78,15,11,52,26,132,Beans,Espresso,Decaf Espresso,Utah,50,70,50,120,Decaf,2
2012-12-01T00:00:00,435,West,Small Market,898,50,123,73,14,12,47,26,123,Beans,Espresso,Decaf Espresso,Utah,40,70,50,110,Decaf,-3
2012-12-01T00:00:00,435,West,Small Market,327,52,127,75,16,23,36,39,127,Leaves,Herbal Tea,Chamomile,Utah,40,70,40,110,Decaf,-4
2013-10-01T00:00:00,435,West,Small Market,447,45,114,69,14,21,34,46,121,Leaves,Herbal Tea,Lemon,Utah,20,70,60,90,Decaf,-26
2013-11-01T00:00:00,435,West,Small Market,885,54,132,78,15,-14,77,26,141,Beans,Espresso,Decaf Espresso,Utah,50,70,50,120,Decaf,27
2013-12-01T00:00:00,435,West,Small Market,898,50,123,73,14,-11,70,26,131,Beans,Espresso,Decaf Espresso,Utah,40,70,50,110,Decaf,20
2013-12-01T00:00:00,435,West,Small Market,327,52,127,75,16,6,53,39,135,Leaves,Herbal Tea,Chamomile,Utah,40,70,40,110,Decaf,13
2013-12-01T00:00:00,435,West,Small Market,462,48,122,74,15,17,42,46,130,Leaves,Herbal Tea,Lemon,Utah,40,70,40,110,Decaf,2
2012-10-01T00:00:00,435,West,Small Market,244,39,92,53,12,27,14,39,92,Leaves,Tea,Earl Grey,Utah,10,30,20,40,Regular,-6
2012-11-01T00:00:00,435,West,Small Market,248,35,82,47,11,27,9,38,82,Leaves,Tea,Earl Grey,Utah,20,30,10,50,Regular,-1
2013-10-01T00:00:00,435,West,Small Market,244,39,92,53,12,20,21,39,98,Leaves,Tea,Earl Grey,Utah,10,30,20,40,Regular,1
2013-11-01T00:00:00,435,West,Small Market,248,35,82,47,11,23,13,38,87,Leaves,Tea,Earl Grey,Utah,20,30,10,50,Regular,3
2013-11-01T00:00:00,435,West,Small Market,211,34,76,42,12,34,-4,45,81,Leaves,Tea,Green Tea,Utah,20,30,0,50,Regular,-4
2012-11-01T00:00:00,435,West,Small Market,380,53,124,71,17,27,27,44,124,Beans,Coffee,Colombian,Utah,60,80,50,140,Regular,-23
2013-11-01T00:00:00,435,West,Small Market,380,53,124,71,17,14,40,44,132,Beans,Coffee,Colombian,Utah,60,80,50,140,Regular,-10
2013-12-01T00:00:00,435,West,Small Market,392,49,114,65,16,18,31,44,121,Beans,Coffee,Colombian,Utah,50,80,50,130,Regular,-19
2012-10-01T00:00:00,435,West,Small Market,593,79,177,98,30,34,34,64,177,Beans,Coffee,Decaf Irish Cream,Utah,100,160,120,260,Decaf,-86
2012-10-01T00:00:00,435,West,Small Market,1053,65,142,77,20,21,36,41,142,Beans,Coffee,Amaretto,Utah,90,110,90,200,Regular,-54
2012-10-01T00:00:00,435,West,Small Market,375,47,111,64,15,27,22,42,111,Beans,Coffee,Colombian,Utah,50,100,80,150,Regular,-58
2012-10-01T00:00:00,435,West,Small Market,1698,86,109,23,26,24,-27,50,109,Leaves,Herbal Tea,Mint,Utah,60,20,0,80,Decaf,-27
2012-10-01T00:00:00,435,West,Small Market,209,25,56,31,9,34,-12,43,56,Leaves,Tea,Green Tea,Utah,0,20,10,20,Regular,-22
2012-11-01T00:00:00,435,West,Small Market,552,101,231,130,33,12,85,45,231,Beans,Espresso,Caffe Mocha,Utah,90,130,90,220,Regular,-5
2012-12-01T00:00:00,435,West,Small Market,619,68,153,85,25,34,26,59,153,Beans,Coffee,Decaf Irish Cream,Utah,80,100,50,180,Decaf,-24
2012-12-01T00:00:00,435,West,Small Market,1075,63,139,76,19,21,36,40,139,Beans,Coffee,Amaretto,Utah,70,90,50,160,Regular,-14
2012-12-01T00:00:00,435,West,Small Market,540,94,214,120,31,12,77,43,214,Beans,Espresso,Caffe Mocha,Utah,90,110,70,200,Regular,7
2012-12-01T00:00:00,435,West,Small Market,218,20,45,25,7,33,-15,40,45,Leaves,Tea,Green Tea,Utah,10,20,0,30,Regular,-15
2013-10-01T00:00:00,435,West,Small Market,593,79,177,98,30,18,50,64,189,Beans,Coffee,Decaf Irish Cream,Utah,100,160,120,260,Decaf,-70
2013-10-01T00:00:00,435,West,Small Market,1053,65,142,77,20,4,53,41,151,Beans,Coffee,Amaretto,Utah,90,110,90,200,Regular,-37
2013-10-01T00:00:00,435,West,Small Market,375,47,111,64,15,16,33,42,118,Beans,Coffee,Colombian,Utah,50,100,80,150,Regular,-47
2013-10-01T00:00:00,435,West,Small Market,564,103,236,133,33,-29,129,46,251,Beans,Espresso,Caffe Mocha,Utah,80,130,110,210,Regular,19
2013-10-01T00:00:00,435,West,Small Market,1698,86,109,23,26,37,-40,50,116,Leaves,Herbal Tea,Mint,Utah,60,20,0,80,Decaf,-40
2013-10-01T00:00:00,435,West,Small Market,209,25,56,31,9,40,-18,43,60,Leaves,Tea,Green Tea,Utah,0,20,10,20,Regular,-28
2013-11-01T00:00:00,435,West,Small Market,601,82,184,102,31,15,56,64,196,Beans,Coffee,Decaf Irish Cream,Utah,90,120,60,210,Decaf,-4
2013-11-01T00:00:00,435,West,Small Market,1060,69,150,81,21,2,58,42,160,Beans,Coffee,Amaretto,Utah,80,90,50,170,Regular,8
2013-12-01T00:00:00,435,West,Small Market,1075,63,139,76,19,4,53,40,148,Beans,Coffee,Amaretto,Utah,70,90,50,160,Regular,3
2013-12-01T00:00:00,435,West,Small Market,540,94,214,120,31,-25,114,43,228,Beans,Espresso,Caffe Mocha,Utah,90,110,70,200,Regular,44
2013-12-01T00:00:00,435,West,Small Market,218,20,45,25,7,40,-22,40,48,Leaves,Tea,Green Tea,Utah,10,20,0,30,Regular,-22
2013-11-01T00:00:00,440,Central,Major Market,482,32,80,48,8,-3,43,19,85,Leaves,Herbal Tea,Chamomile,Ohio,30,40,30,70,Decaf,13
2013-12-01T00:00:00,440,Central,Major Market,870,33,82,49,9,-3,43,20,87,Leaves,Herbal Tea,Lemon,Ohio,30,40,30,70,Decaf,13
2012-10-01T00:00:00,440,Central,Major Market,405,52,123,71,17,28,26,45,123,Beans,Coffee,Amaretto,Ohio,40,70,60,110,Regular,-34
2012-11-01T00:00:00,440,Central,Major Market,1283,181,363,182,50,25,107,75,363,Beans,Espresso,Caffe Mocha,Ohio,230,230,170,460,Regular,-63
2012-12-01T00:00:00,469,South,Major Market,424,54,127,73,17,28,28,45,127,Leaves,Herbal Tea,Chamomile,Texas,50,60,30,110,Decaf,-2
2012-12-01T00:00:00,475,East,Small Market,619,68,153,85,25,33,27,58,153,Leaves,Herbal Tea,Lemon,Connecticut,50,60,20,110,Decaf,7
2012-12-01T00:00:00,475,East,Small Market,1075,63,139,76,19,21,36,40,139,Leaves,Herbal Tea,Mint,Connecticut,40,60,40,100,Decaf,-4
2013-10-01T00:00:00,475,East,Small Market,881,40,99,59,11,-5,53,23,106,Leaves,Tea,Darjeeling,Connecticut,40,60,50,100,Regular,3
2012-11-01T00:00:00,475,East,Small Market,1060,69,150,81,21,22,38,43,150,Leaves,Herbal Tea,Mint,Connecticut,50,50,30,100,Decaf,8
2012-12-01T00:00:00,475,East,Small Market,627,55,131,76,49,29,-2,78,131,Beans,Espresso,Caffe Mocha,Connecticut,50,70,10,120,Regular,-12
2013-11-01T00:00:00,475,East,Small Market,601,82,184,102,31,15,56,64,196,Leaves,Herbal Tea,Lemon,Connecticut,60,70,30,130,Decaf,26
2013-11-01T00:00:00,475,East,Small Market,613,61,147,86,55,28,3,84,157,Beans,Espresso,Caffe Mocha,Connecticut,60,80,10,140,Regular,-7
2012-10-01T00:00:00,503,West,Small Market,404,54,120,66,20,34,12,54,120,Beans,Espresso,Caffe Latte,Oregon,40,60,40,100,Regular,-28
2013-10-01T00:00:00,503,West,Small Market,788,82,205,123,27,1,95,59,218,Leaves,Tea,Earl Grey,Oregon,30,60,50,90,Regular,45
2012-12-01T00:00:00,503,West,Small Market,482,41,98,57,13,43,1,56,98,Beans,Coffee,Colombian,Oregon,40,70,20,110,Regular,-19
2012-12-01T00:00:00,503,West,Small Market,424,54,127,73,17,28,28,45,127,Beans,Espresso,Caffe Mocha,Oregon,50,70,40,120,Regular,-12
2013-11-01T00:00:00,503,West,Small Market,410,55,124,69,20,25,24,53,132,Beans,Espresso,Caffe Latte,Oregon,50,70,30,120,Regular,-6
2013-12-01T00:00:00,503,West,Small Market,424,54,127,73,17,14,42,45,135,Beans,Espresso,Caffe Mocha,Oregon,50,70,40,120,Regular,2
2012-11-01T00:00:00,503,West,Small Market,823,25,63,38,7,12,19,19,63,Leaves,Herbal Tea,Chamomile,Oregon,20,30,20,50,Decaf,-1
2013-11-01T00:00:00,503,West,Small Market,482,32,80,48,8,-2,42,20,85,Leaves,Tea,Darjeeling,Oregon,20,30,30,50,Regular,12
2013-12-01T00:00:00,503,West,Small Market,829,24,60,36,6,2,28,17,64,Leaves,Herbal Tea,Chamomile,Oregon,20,30,20,50,Decaf,8
2012-11-01T00:00:00,503,West,Small Market,424,46,114,68,14,22,32,36,114,Beans,Coffee,Decaf Irish Cream,Oregon,50,80,50,130,Decaf,-18
2012-11-01T00:00:00,503,West,Small Market,411,59,138,79,19,27,33,46,138,Beans,Espresso,Caffe Mocha,Oregon,50,80,50,130,Regular,-17
2012-12-01T00:00:00,503,West,Small Market,435,41,101,60,13,22,25,35,101,Beans,Coffee,Decaf Irish Cream,Oregon,40,80,50,120,Decaf,-25
2012-12-01T00:00:00,503,West,Small Market,521,47,112,65,42,30,-7,72,112,Beans,Coffee,Amaretto,Oregon,50,80,20,130,Regular,-27
2013-11-01T00:00:00,503,West,Small Market,424,46,114,68,14,7,47,36,121,Beans,Coffee,Decaf Irish Cream,Oregon,50,80,50,130,Decaf,-3
2012-10-01T00:00:00,503,West,Small Market,1267,161,322,161,45,25,91,70,322,Beans,Espresso,Decaf Espresso,Oregon,140,150,110,290,Decaf,-19
2012-11-01T00:00:00,503,West,Small Market,1283,181,363,182,50,24,108,74,363,Beans,Espresso,Decaf Espresso,Oregon,170,180,120,350,Decaf,-12
2012-12-01T00:00:00,503,West,Small Market,690,134,320,186,41,24,121,65,320,Leaves,Tea,Green Tea,Oregon,90,140,100,230,Regular,21
2013-10-01T00:00:00,503,West,Small Market,1267,161,322,161,45,-19,135,70,343,Beans,Espresso,Decaf Espresso,Oregon,140,150,110,290,Decaf,25
2013-10-01T00:00:00,503,West,Small Market,503,51,122,71,46,32,-7,76,130,Beans,Coffee,Amaretto,Oregon,70,100,50,170,Regular,-57
2013-10-01T00:00:00,503,West,Small Market,463,60,144,84,19,34,31,63,153,Beans,Coffee,Colombian,Oregon,80,130,90,210,Regular,-59
2013-11-01T00:00:00,503,West,Small Market,798,78,197,119,25,2,92,57,210,Leaves,Tea,Earl Grey,Oregon,50,90,50,140,Regular,42
2013-12-01T00:00:00,503,West,Small Market,551,81,185,104,26,-20,98,38,197,Leaves,Herbal Tea,Lemon,Oregon,70,100,70,170,Decaf,28
2013-12-01T00:00:00,503,West,Small Market,690,134,320,186,41,-35,180,65,341,Leaves,Tea,Green Tea,Oregon,90,140,100,230,Regular,80
2012-11-01T00:00:00,504,South,Small Market,856,31,78,47,8,11,28,19,78,Beans,Coffee,Decaf Irish Cream,Louisiana,30,60,50,90,Decaf,-22
2013-10-01T00:00:00,504,South,Small Market,-762,60,144,84,54,29,1,83,153,Beans,Espresso,Caffe Latte,Louisiana,30,60,10,90,Regular,-9
2013-11-01T00:00:00,504,South,Small Market,856,31,78,47,8,-3,42,19,83,Beans,Coffee,Decaf Irish Cream,Louisiana,30,60,50,90,Decaf,-8
2012-11-01T00:00:00,504,South,Small Market,-906,61,147,86,55,30,1,85,147,Beans,Espresso,Caffe Latte,Louisiana,40,70,10,110,Regular,-9
2012-10-01T00:00:00,504,South,Small Market,593,79,177,98,30,34,34,64,177,Leaves,Herbal Tea,Lemon,Louisiana,60,90,60,150,Decaf,-26
2012-12-01T00:00:00,505,South,Small Market,335,49,118,69,44,30,-5,74,118,Beans,Espresso,Caffe Mocha,New Mexico,30,60,10,90,Regular,-15
2013-12-01T00:00:00,505,South,Small Market,335,49,118,69,44,32,-7,74,126,Beans,Espresso,Caffe Mocha,New Mexico,30,60,10,90,Regular,-17
2012-11-01T00:00:00,505,South,Small Market,1804,82,122,40,25,23,-8,48,122,Beans,Coffee,Decaf Irish Cream,New Mexico,90,50,10,140,Decaf,-18
2012-11-01T00:00:00,505,South,Small Market,325,44,106,62,40,29,-7,69,106,Beans,Espresso,Caffe Mocha,New Mexico,30,50,0,80,Regular,-7
2013-11-01T00:00:00,505,South,Small Market,1804,82,122,40,25,27,-12,48,130,Beans,Coffee,Decaf Irish Cream,New Mexico,90,50,10,140,Decaf,-22
2013-11-01T00:00:00,505,South,Small Market,325,44,106,62,40,32,-10,69,113,Beans,Espresso,Caffe Mocha,New Mexico,30,50,0,80,Regular,-10
2012-10-01T00:00:00,505,South,Small Market,1698,86,109,23,26,23,-26,49,109,Beans,Coffee,Decaf Irish Cream,New Mexico,110,40,10,150,Decaf,-36
2012-10-01T00:00:00,505,South,Small Market,320,45,109,64,41,29,-6,70,109,Beans,Espresso,Caffe Mocha,New Mexico,20,40,10,60,Regular,-16
2012-10-01T00:00:00,505,South,Small Market,1000,31,68,37,9,22,6,31,68,Leaves,Herbal Tea,Lemon,New Mexico,10,40,30,50,Decaf,-24
2012-11-01T00:00:00,505,South,Small Market,248,35,82,47,11,28,8,39,82,Beans,Espresso,Decaf Espresso,New Mexico,20,40,20,60,Decaf,-12
2012-12-01T00:00:00,505,South,Small Market,1009,31,69,38,9,22,7,31,69,Leaves,Herbal Tea,Lemon,New Mexico,20,40,20,60,Decaf,-13
2013-10-01T00:00:00,505,South,Small Market,1698,86,109,23,26,36,-39,49,116,Beans,Coffee,Decaf Irish Cream,New Mexico,110,40,10,150,Decaf,-49
2013-10-01T00:00:00,505,South,Small Market,320,45,109,64,41,32,-9,70,116,Beans,Espresso,Caffe Mocha,New Mexico,20,40,10,60,Regular,-19
2013-10-01T00:00:00,505,South,Small Market,1000,31,68,37,9,19,9,31,72,Leaves,Herbal Tea,Lemon,New Mexico,10,40,30,50,Decaf,-21
2013-11-01T00:00:00,505,South,Small Market,248,35,82,47,11,24,12,39,87,Beans,Espresso,Decaf Espresso,New Mexico,20,40,20,60,Decaf,-8
2013-12-01T00:00:00,505,South,Small Market,1009,31,69,38,9,19,10,31,74,Leaves,Herbal Tea,Lemon,New Mexico,20,40,20,60,Decaf,-10
2012-11-01T00:00:00,505,South,Small Market,452,43,109,66,14,32,20,46,109,Beans,Coffee,Colombian,New Mexico,50,70,30,120,Regular,-10
2013-11-01T00:00:00,505,South,Small Market,452,43,109,66,14,22,30,46,116,Beans,Coffee,Colombian,New Mexico,50,70,30,120,Regular,0
2012-10-01T00:00:00,505,South,Small Market,244,39,92,53,12,27,14,39,92,Beans,Espresso,Decaf Espresso,New Mexico,20,30,20,50,Decaf,-6
2012-10-01T00:00:00,505,South,Small Market,846,21,52,31,5,12,14,17,52,Leaves,Herbal Tea,Chamomile,New Mexico,10,30,30,40,Decaf,-16
2012-11-01T00:00:00,505,South,Small Market,-522,34,76,42,12,34,-4,46,76,Beans,Espresso,Caffe Latte,New Mexico,20,30,-10,50,Regular,6
2012-11-01T00:00:00,505,South,Small Market,1003,29,64,35,8,22,5,30,64,Leaves,Herbal Tea,Lemon,New Mexico,20,30,10,50,Decaf,-5
2012-12-01T00:00:00,505,South,Small Market,256,38,89,51,12,27,12,39,89,Beans,Espresso,Decaf Espresso,New Mexico,30,30,0,60,Decaf,12
2013-10-01T00:00:00,505,South,Small Market,244,39,92,53,12,20,21,39,98,Beans,Espresso,Decaf Espresso,New Mexico,20,30,20,50,Decaf,1
2013-10-01T00:00:00,505,South,Small Market,846,21,52,31,5,5,21,17,55,Leaves,Herbal Tea,Chamomile,New Mexico,10,30,30,40,Decaf,-9
2013-11-01T00:00:00,505,South,Small Market,-522,34,76,42,12,36,-6,46,81,Beans,Espresso,Caffe Latte,New Mexico,20,30,-10,50,Regular,4
2013-11-01T00:00:00,505,South,Small Market,1003,29,64,35,8,20,7,30,68,Leaves,Herbal Tea,Lemon,New Mexico,20,30,10,50,Decaf,-3
2013-12-01T00:00:00,505,South,Small Market,256,38,89,51,12,21,18,39,95,Beans,Espresso,Decaf Espresso,New Mexico,30,30,0,60,Decaf,18
2012-10-01T00:00:00,505,South,Small Market,447,45,114,69,14,32,23,46,114,Beans,Coffee,Colombian,New Mexico,50,110,80,160,Regular,-57
2012-10-01T00:00:00,505,South,Small Market,-466,25,56,31,9,34,-12,43,56,Beans,Espresso,Caffe Latte,New Mexico,10,20,10,30,Regular,-22
2012-11-01T00:00:00,505,South,Small Market,848,15,39,24,4,11,9,15,39,Leaves,Herbal Tea,Chamomile,New Mexico,10,20,10,30,Decaf,-1
2012-12-01T00:00:00,505,South,Small Market,1898,92,160,68,28,24,16,52,160,Beans,Coffee,Decaf Irish Cream,New Mexico,100,90,40,190,Decaf,-24
2012-12-01T00:00:00,505,South,Small Market,462,48,122,74,15,32,27,47,122,Beans,Coffee,Colombian,New Mexico,50,90,50,140,Regular,-23
2012-12-01T00:00:00,505,South,Small Market,-598,20,45,25,7,33,-15,40,45,Beans,Espresso,Caffe Latte,New Mexico,10,20,-10,30,Regular,-5
2012-12-01T00:00:00,505,South,Small Market,851,16,41,25,4,12,9,16,41,Leaves,Herbal Tea,Chamomile,New Mexico,10,20,10,30,Decaf,-1
2013-10-01T00:00:00,505,South,Small Market,447,45,114,69,14,21,34,46,121,Beans,Coffee,Colombian,New Mexico,50,110,80,160,Regular,-46
2013-10-01T00:00:00,505,South,Small Market,-466,25,56,31,9,40,-18,43,60,Beans,Espresso,Caffe Latte,New Mexico,10,20,10,30,Regular,-28
2013-11-01T00:00:00,505,South,Small Market,848,15,39,24,4,7,13,15,42,Leaves,Herbal Tea,Chamomile,New Mexico,10,20,10,30,Decaf,3
2013-12-01T00:00:00,505,South,Small Market,1898,92,160,68,28,16,24,52,171,Beans,Coffee,Decaf Irish Cream,New Mexico,100,90,40,190,Decaf,-16
2013-12-01T00:00:00,505,South,Small Market,462,48,122,74,15,19,40,47,130,Beans,Coffee,Colombian,New Mexico,50,90,50,140,Regular,-10
2013-12-01T00:00:00,505,South,Small Market,-598,20,45,25,7,40,-22,40,48,Beans,Espresso,Caffe Latte,New Mexico,10,20,-10,30,Regular,-12
2013-12-01T00:00:00,505,South,Small Market,851,16,41,25,4,8,13,16,44,Leaves,Herbal Tea,Chamomile,New Mexico,10,20,10,30,Decaf,3
2012-10-01T00:00:00,508,East,Major Market,859,27,66,39,7,12,20,19,66,Leaves,Tea,Darjeeling,Massachusetts,20,50,50,70,Regular,-30
2012-12-01T00:00:00,508,East,Major Market,422,46,103,57,17,33,7,50,103,Leaves,Herbal Tea,Lemon,Massachusetts,30,40,10,70,Decaf,-3
2012-11-01T00:00:00,508,East,Major Market,1283,181,363,182,50,24,108,74,363,Beans,Espresso,Regular Espresso,Massachusetts,170,180,120,350,Regular,-12
2013-10-01T00:00:00,508,East,Major Market,1267,161,322,161,45,-21,137,69,343,Beans,Espresso,Regular Espresso,Massachusetts,140,160,120,300,Regular,17
2012-11-01T00:00:00,509,West,Small Market,834,47,115,68,13,11,44,24,115,Leaves,Herbal Tea,Lemon,Washington,40,60,40,100,Decaf,4
2013-10-01T00:00:00,509,West,Small Market,829,48,119,71,13,-12,70,24,127,Leaves,Herbal Tea,Lemon,Washington,30,60,60,90,Decaf,10
2013-11-01T00:00:00,509,West,Small Market,613,61,147,86,55,30,1,85,157,Leaves,Tea,Green Tea,Washington,40,60,0,100,Regular,1
2013-12-01T00:00:00,509,West,Small Market,627,55,131,76,49,31,-4,79,140,Leaves,Tea,Green Tea,Washington,40,50,-10,90,Regular,6
2012-12-01T00:00:00,509,West,Small Market,320,41,107,66,12,24,30,36,107,Leaves,Tea,Darjeeling,Washington,30,40,20,70,Regular,10
2012-12-01T00:00:00,509,West,Small Market,466,43,106,63,13,22,28,35,106,Leaves,Tea,Earl Grey,Washington,30,40,20,70,Regular,8
2013-11-01T00:00:00,509,West,Small Market,321,53,141,88,16,-1,73,39,150,Leaves,Tea,Darjeeling,Washington,30,70,50,100,Regular,23
2013-10-01T00:00:00,509,West,Small Market,449,46,113,67,14,7,46,36,120,Leaves,Tea,Earl Grey,Washington,20,30,30,50,Regular,16
2012-12-01T00:00:00,509,West,Small Market,403,65,145,80,24,33,23,57,145,Beans,Espresso,Caffe Mocha,Washington,60,80,30,140,Regular,-7
2013-12-01T00:00:00,509,West,Small Market,403,65,145,80,24,22,34,57,155,Beans,Espresso,Caffe Mocha,Washington,60,80,30,140,Regular,4
2012-12-01T00:00:00,509,West,Small Market,716,105,250,145,95,30,20,125,250,Beans,Coffee,Decaf Irish Cream,Washington,120,170,50,290,Decaf,-30
2012-12-01T00:00:00,509,West,Small Market,1166,115,289,174,37,32,105,69,289,Leaves,Herbal Tea,Chamomile,Washington,100,160,110,260,Decaf,-5
2013-11-01T00:00:00,509,West,Small Market,694,94,224,130,85,21,24,114,239,Beans,Coffee,Decaf Irish Cream,Washington,110,150,40,260,Decaf,-16
2013-10-01T00:00:00,510,West,Major Market,650,72,182,110,23,4,83,54,194,Leaves,Tea,Green Tea,California,20,60,50,80,Regular,33
2013-12-01T00:00:00,510,West,Major Market,677,67,168,101,22,9,70,54,179,Leaves,Tea,Green Tea,California,40,80,50,120,Regular,20
2013-11-01T00:00:00,510,West,Major Market,1272,225,490,265,69,-62,258,91,522,Leaves,Herbal Tea,Lemon,California,210,240,160,450,Decaf,98
2012-12-01T00:00:00,512,South,Major Market,-1239,67,168,101,22,32,47,54,168,Beans,Espresso,Caffe Latte,Texas,50,70,30,120,Regular,17
2012-12-01T00:00:00,513,Central,Major Market,424,54,127,73,17,27,29,44,127,Beans,Coffee,Amaretto,Ohio,50,70,40,120,Regular,-11
2013-12-01T00:00:00,513,Central,Major Market,521,47,112,65,42,32,-9,71,119,Beans,Coffee,Decaf Irish Cream,Ohio,40,70,10,110,Decaf,-19
2012-10-01T00:00:00,513,Central,Major Market,859,27,66,39,7,12,20,19,66,Leaves,Herbal Tea,Lemon,Ohio,10,30,30,40,Decaf,-10
2012-12-01T00:00:00,513,Central,Major Market,817,88,221,133,29,32,72,61,221,Leaves,Tea,Darjeeling,Ohio,70,110,70,180,Regular,2
2013-10-01T00:00:00,513,Central,Major Market,1267,161,322,161,45,-21,137,69,343,Beans,Espresso,Caffe Mocha,Ohio,230,240,190,470,Regular,-53
2013-12-01T00:00:00,513,Central,Major Market,817,88,221,133,29,-3,107,61,236,Leaves,Tea,Darjeeling,Ohio,70,110,70,180,Regular,37
2013-12-01T00:00:00,513,Central,Major Market,690,134,320,186,41,-35,180,65,341,Leaves,Tea,Earl Grey,Ohio,110,150,90,260,Regular,90
2012-11-01T00:00:00,515,Central,Small Market,802,22,56,34,6,12,16,18,56,Beans,Espresso,Caffe Mocha,Iowa,20,50,40,70,Regular,-24
2012-12-01T00:00:00,515,Central,Small Market,807,23,58,35,6,12,17,18,58,Beans,Espresso,Caffe Mocha,Iowa,20,50,40,70,Regular,-23
2013-11-01T00:00:00,515,Central,Small Market,387,0,43,43,0,-3,46,12,46,Beans,Espresso,Decaf Espresso,Iowa,0,50,40,50,Decaf,6
2013-11-01T00:00:00,515,Central,Small Market,802,22,56,34,6,4,24,18,60,Beans,Espresso,Caffe Mocha,Iowa,20,50,40,70,Regular,-16
2013-12-01T00:00:00,515,Central,Small Market,807,23,58,35,6,4,25,18,62,Beans,Espresso,Caffe Mocha,Iowa,20,50,40,70,Regular,-15
2012-10-01T00:00:00,515,Central,Small Market,1000,31,68,37,9,21,7,30,68,Beans,Coffee,Colombian,Iowa,20,40,30,60,Regular,-23
2013-10-01T00:00:00,515,Central,Small Market,1000,31,68,37,9,18,10,30,72,Beans,Coffee,Colombian,Iowa,20,40,30,60,Regular,-20
2013-11-01T00:00:00,515,Central,Small Market,1003,29,64,35,8,20,7,30,68,Beans,Coffee,Colombian,Iowa,20,40,20,60,Regular,-13
2013-10-01T00:00:00,515,Central,Small Market,846,21,52,31,5,4,22,16,55,Beans,Coffee,Amaretto,Iowa,10,30,30,40,Regular,-8
2013-10-01T00:00:00,515,Central,Small Market,789,122,298,176,39,-32,169,62,318,Leaves,Herbal Tea,Lemon,Iowa,90,150,130,240,Decaf,39
2013-10-01T00:00:00,515,Central,Small Market,1755,239,478,239,66,-48,221,90,509,Leaves,Tea,Darjeeling,Iowa,170,170,110,340,Regular,111
2013-10-01T00:00:00,515,Central,Small Market,1756,255,567,312,96,-56,272,129,604,Leaves,Tea,Earl Grey,Iowa,170,230,130,400,Regular,142
2013-12-01T00:00:00,515,Central,Small Market,1744,247,576,329,81,-73,321,113,614,Leaves,Herbal Tea,Chamomile,Iowa,230,300,200,530,Decaf,121
2013-12-01T00:00:00,515,Central,Small Market,830,127,312,185,40,-38,183,62,332,Leaves,Herbal Tea,Lemon,Iowa,120,170,120,290,Decaf,63
2012-10-01T00:00:00,516,East,Major Market,971,108,265,157,30,12,115,42,265,Leaves,Tea,Darjeeling,New York,110,170,140,280,Regular,-25
2013-11-01T00:00:00,516,East,Major Market,984,81,198,117,22,-30,125,33,211,Leaves,Tea,Darjeeling,New York,80,120,90,200,Regular,35
2012-12-01T00:00:00,518,East,Major Market,601,54,133,79,15,12,52,27,133,Leaves,Tea,Green Tea,New York,50,80,60,130,Regular,-8
2012-10-01T00:00:00,518,East,Major Market,580,76,187,111,21,12,78,33,187,Leaves,Tea,Green Tea,New York,80,120,100,200,Regular,-22
2012-11-01T00:00:00,518,East,Major Market,984,81,198,117,22,11,84,33,198,Leaves,Tea,Darjeeling,New York,80,120,90,200,Regular,-6
2013-11-01T00:00:00,518,East,Major Market,4742,225,160,-65,69,98,-232,91,171,Leaves,Herbal Tea,Mint,New York,160,-50,-120,110,Decaf,-112
2013-12-01T00:00:00,518,East,Major Market,723,250,657,407,70,-126,463,95,700,Beans,Espresso,Regular Espresso,New York,240,400,320,640,Regular,143
2013-12-01T00:00:00,518,East,Major Market,959,123,302,179,34,-52,197,46,322,Leaves,Tea,Earl Grey,New York,120,190,150,310,Regular,47
2013-10-01T00:00:00,530,West,Major Market,541,39,90,51,12,0,39,25,96,Leaves,Herbal Tea,Mint,California,20,40,40,60,Decaf,-1
2012-12-01T00:00:00,530,West,Major Market,940,135,322,187,122,34,31,156,322,Beans,Espresso,Caffe Mocha,California,130,180,40,310,Regular,-9
2013-12-01T00:00:00,530,West,Major Market,2642,279,699,420,97,-79,402,149,745,Beans,Coffee,Colombian,California,330,500,350,830,Regular,52
2013-12-01T00:00:00,530,West,Major Market,940,135,322,187,122,19,46,156,343,Beans,Espresso,Caffe Mocha,California,130,180,40,310,Regular,6
2013-10-01T00:00:00,541,West,Small Market,656,91,218,127,28,-14,113,51,232,Leaves,Tea,Green Tea,Oregon,40,60,50,100,Regular,63
2012-11-01T00:00:00,541,West,Small Market,410,55,124,69,20,33,16,53,124,Beans,Espresso,Caffe Latte,Oregon,50,70,30,120,Regular,-14
2013-10-01T00:00:00,541,West,Small Market,405,52,123,71,17,14,40,44,131,Beans,Espresso,Caffe Mocha,Oregon,30,70,60,100,Regular,-20
2013-12-01T00:00:00,541,West,Small Market,482,41,98,57,13,43,1,56,104,Beans,Coffee,Colombian,Oregon,40,70,20,110,Regular,-19
2012-11-01T00:00:00,541,West,Small Market,482,32,80,48,8,12,28,20,80,Leaves,Tea,Darjeeling,Oregon,20,30,30,50,Regular,-2
2012-12-01T00:00:00,541,West,Small Market,829,24,60,36,6,11,19,17,60,Leaves,Herbal Tea,Chamomile,Oregon,20,30,20,50,Decaf,-1
2013-11-01T00:00:00,541,West,Small Market,823,25,63,38,7,3,28,19,67,Leaves,Herbal Tea,Chamomile,Oregon,20,30,20,50,Decaf,8
2013-12-01T00:00:00,541,West,Small Market,490,29,73,44,8,-1,37,19,78,Leaves,Tea,Darjeeling,Oregon,20,30,30,50,Regular,7
2012-11-01T00:00:00,541,West,Small Market,509,52,125,73,47,30,-4,77,125,Beans,Coffee,Amaretto,Oregon,60,80,10,140,Regular,-14
2013-11-01T00:00:00,541,West,Small Market,411,59,138,79,19,11,49,46,147,Beans,Espresso,Caffe Mocha,Oregon,50,80,50,130,Regular,-1
2013-12-01T00:00:00,541,West,Small Market,435,41,101,60,13,10,37,35,108,Beans,Coffee,Decaf Irish Cream,Oregon,40,80,50,120,Decaf,-13
2013-12-01T00:00:00,541,West,Small Market,521,47,112,65,42,33,-10,72,119,Beans,Coffee,Amaretto,Oregon,50,80,20,130,Regular,-30
2012-10-01T00:00:00,541,West,Small Market,480,21,53,32,5,11,16,16,53,Leaves,Tea,Darjeeling,Oregon,0,20,20,20,Regular,-4
2012-12-01T00:00:00,541,West,Small Market,551,81,185,104,26,12,66,38,185,Leaves,Herbal Tea,Lemon,Oregon,70,100,70,170,Decaf,-4
2013-10-01T00:00:00,541,West,Small Market,572,90,205,115,29,-22,108,42,218,Leaves,Herbal Tea,Lemon,Oregon,60,100,90,160,Decaf,18
2013-11-01T00:00:00,541,West,Small Market,470,53,128,75,17,37,21,61,136,Beans,Coffee,Colombian,Oregon,60,90,40,150,Regular,-19
2013-11-01T00:00:00,541,West,Small Market,561,88,200,112,29,-21,104,42,213,Leaves,Herbal Tea,Lemon,Oregon,80,100,70,180,Decaf,34
2012-11-01T00:00:00,559,West,Major Market,1778,211,423,212,59,24,129,83,423,Beans,Espresso,Caffe Latte,California,200,210,140,410,Regular,-11
2012-12-01T00:00:00,561,East,Major Market,1079,80,176,96,24,22,50,46,176,Leaves,Herbal Tea,Mint,Florida,60,60,30,120,Decaf,20
2013-10-01T00:00:00,561,East,Major Market,871,38,94,56,10,-6,52,21,100,Leaves,Tea,Darjeeling,Florida,40,60,50,100,Regular,2
2013-11-01T00:00:00,561,East,Major Market,1063,75,164,89,23,1,65,45,175,Leaves,Herbal Tea,Mint,Florida,50,60,30,110,Decaf,35
2012-11-01T00:00:00,561,East,Major Market,856,31,78,47,8,11,28,19,78,Leaves,Tea,Green Tea,Florida,30,50,40,80,Regular,-12
2013-11-01T00:00:00,561,East,Major Market,391,54,121,67,20,28,19,54,129,Leaves,Herbal Tea,Lemon,Florida,40,40,10,80,Decaf,9
2012-10-01T00:00:00,561,East,Major Market,656,91,218,127,28,23,76,51,218,Beans,Coffee,Decaf Irish Cream,Florida,70,110,90,180,Decaf,-14
2012-11-01T00:00:00,561,East,Major Market,557,77,180,103,25,27,51,52,180,Beans,Espresso,Decaf Espresso,Florida,70,100,60,170,Decaf,-9
2012-11-01T00:00:00,561,East,Major Market,570,22,52,30,7,12,11,19,52,Leaves,Herbal Tea,Chamomile,Florida,10,20,10,30,Decaf,1
2012-10-01T00:00:00,562,West,Major Market,650,72,182,110,23,31,56,54,182,Leaves,Tea,Green Tea,California,20,60,50,80,Regular,6
2012-10-01T00:00:00,562,West,Major Market,1755,239,478,239,66,24,149,90,478,Beans,Espresso,Caffe Latte,California,210,220,160,430,Regular,-11
2012-10-01T00:00:00,562,West,Major Market,898,125,298,173,113,33,27,146,298,Beans,Espresso,Caffe Mocha,California,110,160,50,270,Regular,-23
2012-10-01T00:00:00,562,West,Major Market,1246,239,520,281,74,21,186,95,520,Leaves,Herbal Tea,Lemon,California,190,220,170,410,Decaf,16
2012-10-01T00:00:00,562,West,Major Market,915,123,302,179,34,11,134,45,302,Leaves,Tea,Darjeeling,California,50,90,80,140,Regular,54
2013-10-01T00:00:00,563,Central,Small Market,430,0,43,43,0,-3,46,12,46,Beans,Espresso,Decaf Espresso,Iowa,0,60,60,60,Decaf,-14
2013-12-01T00:00:00,563,Central,Small Market,344,0,43,43,0,-4,47,11,46,Beans,Espresso,Decaf Espresso,Iowa,0,50,40,50,Decaf,7
2012-11-01T00:00:00,563,Central,Small Market,1003,29,64,35,8,22,5,30,64,Beans,Coffee,Colombian,Iowa,20,40,20,60,Regular,-15
2012-10-01T00:00:00,563,Central,Small Market,846,21,52,31,5,11,15,16,52,Beans,Coffee,Amaretto,Iowa,10,30,30,40,Regular,-15
2012-12-01T00:00:00,563,Central,Small Market,1009,31,69,38,9,21,8,30,69,Beans,Coffee,Colombian,Iowa,30,30,10,60,Regular,-2
2013-12-01T00:00:00,563,Central,Small Market,851,16,41,25,4,6,15,15,44,Beans,Coffee,Amaretto,Iowa,10,30,20,40,Regular,-5
2012-10-01T00:00:00,563,Central,Small Market,1755,239,478,239,66,24,149,90,478,Leaves,Tea,Darjeeling,Iowa,170,170,110,340,Regular,39
2012-10-01T00:00:00,563,Central,Small Market,1756,255,567,312,96,33,183,129,567,Leaves,Tea,Earl Grey,Iowa,170,230,130,400,Regular,53
2012-11-01T00:00:00,563,Central,Small Market,848,15,39,24,4,12,8,16,39,Beans,Coffee,Amaretto,Iowa,10,20,10,30,Regular,-2
2013-11-01T00:00:00,563,Central,Small Market,1778,211,423,212,59,-38,191,83,451,Leaves,Tea,Darjeeling,Iowa,170,180,110,350,Regular,81
2013-12-01T00:00:00,563,Central,Small Market,1838,294,654,360,111,-72,321,144,697,Leaves,Tea,Earl Grey,Iowa,240,300,170,540,Regular,151
2012-11-01T00:00:00,567,Central,Major Market,509,52,125,73,47,29,-3,76,125,Beans,Coffee,Decaf Irish Cream,Ohio,50,70,10,120,Decaf,-13
2012-10-01T00:00:00,567,Central,Major Market,1267,161,322,161,45,24,92,69,322,Beans,Espresso,Caffe Mocha,Ohio,230,240,190,470,Regular,-98
2012-10-01T00:00:00,573,Central,Small Market,320,45,109,64,41,29,-6,70,109,Leaves,Herbal Tea,Chamomile,Missouri,20,60,30,80,Decaf,-36
2012-12-01T00:00:00,573,Central,Small Market,1898,92,160,68,28,24,16,52,160,Leaves,Herbal Tea,Lemon,Missouri,80,60,20,140,Decaf,-4
2013-10-01T00:00:00,573,Central,Small Market,320,45,109,64,41,32,-9,70,116,Leaves,Herbal Tea,Chamomile,Missouri,20,60,30,80,Decaf,-39
2012-11-01T00:00:00,573,Central,Small Market,325,44,106,62,40,30,-8,70,106,Leaves,Herbal Tea,Chamomile,Missouri,40,50,0,90,Decaf,-8
2012-11-01T00:00:00,573,Central,Small Market,1804,82,122,40,25,24,-9,49,122,Leaves,Herbal Tea,Lemon,Missouri,70,40,0,110,Decaf,-9
2012-12-01T00:00:00,573,Central,Small Market,256,38,89,51,12,28,11,40,89,Leaves,Tea,Darjeeling,Missouri,30,40,10,70,Regular,1
2013-11-01T00:00:00,573,Central,Small Market,211,34,76,42,12,34,-4,45,81,Leaves,Tea,Earl Grey,Missouri,20,40,0,60,Regular,-4
2012-10-01T00:00:00,573,Central,Small Market,1698,86,109,23,26,23,-26,49,109,Leaves,Herbal Tea,Lemon,Missouri,60,20,10,80,Decaf,-36
2012-11-01T00:00:00,573,Central,Small Market,601,82,184,102,31,33,38,64,184,Beans,Coffee,Colombian,Missouri,80,100,40,180,Regular,-2
2012-12-01T00:00:00,573,Central,Small Market,619,68,153,85,25,34,26,59,153,Beans,Coffee,Colombian,Missouri,60,90,40,150,Regular,-14
2012-12-01T00:00:00,573,Central,Small Market,218,20,45,25,7,34,-16,41,45,Leaves,Tea,Earl Grey,Missouri,10,20,-10,30,Regular,-6
2013-10-01T00:00:00,573,Central,Small Market,593,79,177,98,30,16,52,63,189,Beans,Coffee,Colombian,Missouri,70,100,70,170,Regular,-18
2013-10-01T00:00:00,573,Central,Small Market,881,40,99,59,11,-5,53,23,106,Beans,Espresso,Caffe Mocha,Missouri,50,90,90,140,Regular,-37
2013-10-01T00:00:00,573,Central,Small Market,209,25,56,31,9,38,-16,42,60,Leaves,Tea,Earl Grey,Missouri,10,20,0,30,Regular,-16
2013-11-01T00:00:00,573,Central,Small Market,601,82,184,102,31,15,56,64,196,Beans,Coffee,Colombian,Missouri,80,100,40,180,Regular,16
2013-11-01T00:00:00,573,Central,Small Market,885,54,132,78,15,-13,76,27,141,Beans,Espresso,Caffe Mocha,Missouri,60,100,80,160,Regular,-4
2013-12-01T00:00:00,573,Central,Small Market,619,68,153,85,25,21,39,59,163,Beans,Coffee,Colombian,Missouri,60,90,40,150,Regular,-1
2013-12-01T00:00:00,573,Central,Small Market,898,50,123,73,14,-12,71,25,131,Beans,Espresso,Caffe Mocha,Missouri,60,90,70,150,Regular,1
2012-11-01T00:00:00,580,South,Small Market,862,36,88,52,10,12,30,22,88,Beans,Coffee,Decaf Irish Cream,Oklahoma,40,60,40,100,Decaf,-10
2012-12-01T00:00:00,580,South,Small Market,870,33,82,49,9,12,28,21,82,Beans,Coffee,Decaf Irish Cream,Oklahoma,30,60,50,90,Decaf,-22
2013-11-01T00:00:00,580,South,Small Market,862,36,88,52,10,-3,45,22,94,Beans,Coffee,Decaf Irish Cream,Oklahoma,40,60,40,100,Decaf,5
2013-11-01T00:00:00,580,South,Small Market,391,54,121,67,20,28,19,54,129,Leaves,Herbal Tea,Chamomile,Oklahoma,50,60,20,110,Decaf,-1
2013-11-01T00:00:00,580,South,Small Market,482,32,80,48,8,-3,43,19,85,Beans,Espresso,Caffe Mocha,Oklahoma,20,40,30,60,Regular,13
2013-10-01T00:00:00,580,South,Small Market,385,56,126,70,21,25,24,54,134,Leaves,Herbal Tea,Chamomile,Oklahoma,40,70,50,110,Decaf,-26
2012-12-01T00:00:00,580,South,Small Market,490,29,73,44,8,12,24,20,73,Beans,Espresso,Caffe Mocha,Oklahoma,20,30,20,50,Regular,4
2013-10-01T00:00:00,580,South,Small Market,480,21,53,32,5,5,22,17,56,Beans,Espresso,Caffe Mocha,Oklahoma,0,30,30,30,Regular,-8
2013-12-01T00:00:00,580,South,Small Market,490,29,73,44,8,0,36,20,78,Beans,Espresso,Caffe Mocha,Oklahoma,20,30,20,50,Regular,16
2012-11-01T00:00:00,580,South,Small Market,694,94,224,130,85,30,15,115,224,Leaves,Herbal Tea,Lemon,Oklahoma,80,120,20,200,Decaf,-5
2012-12-01T00:00:00,580,South,Small Market,716,105,250,145,95,30,20,125,250,Leaves,Herbal Tea,Lemon,Oklahoma,90,140,30,230,Decaf,-10
2013-11-01T00:00:00,580,South,Small Market,798,78,197,119,25,2,92,57,210,Beans,Espresso,Decaf Espresso,Oklahoma,60,90,40,150,Decaf,52
2013-12-01T00:00:00,580,South,Small Market,551,81,185,104,26,-20,98,38,197,Beans,Coffee,Colombian,Oklahoma,90,130,100,220,Regular,-2
2013-12-01T00:00:00,580,South,Small Market,716,105,250,145,95,20,30,125,266,Leaves,Herbal Tea,Lemon,Oklahoma,90,140,30,230,Decaf,0
2013-12-01T00:00:00,585,East,Major Market,601,54,133,79,15,-13,77,27,142,Leaves,Tea,Green Tea,New York,50,80,60,130,Regular,17
2013-10-01T00:00:00,585,East,Major Market,1622,255,513,258,96,-29,191,129,547,Leaves,Herbal Tea,Lemon,New York,140,150,70,290,Decaf,121
2013-10-01T00:00:00,585,East,Major Market,971,108,265,157,30,-44,171,42,282,Leaves,Tea,Darjeeling,New York,110,170,140,280,Regular,31
2013-11-01T00:00:00,585,East,Major Market,1704,245,576,331,93,-65,303,127,614,Leaves,Herbal Tea,Lemon,New York,180,240,140,420,Decaf,163
2012-10-01T00:00:00,603,East,Small Market,310,49,120,71,15,23,33,38,120,Beans,Coffee,Amaretto,New Hampshire,30,60,60,90,Regular,-27
2012-10-01T00:00:00,603,East,Small Market,447,45,114,69,14,31,24,45,114,Beans,Coffee,Colombian,New Hampshire,30,60,50,90,Regular,-26
2012-10-01T00:00:00,603,East,Small Market,320,45,109,64,41,30,-7,71,109,Beans,Espresso,Caffe Mocha,New Hampshire,30,60,30,90,Regular,-37
2012-11-01T00:00:00,603,East,Small Market,316,46,113,67,14,23,30,37,113,Beans,Coffee,Amaretto,New Hampshire,40,60,40,100,Regular,-10
2012-11-01T00:00:00,603,East,Small Market,452,43,109,66,14,32,20,46,109,Beans,Coffee,Colombian,New Hampshire,30,60,30,90,Regular,-10
2012-11-01T00:00:00,603,East,Small Market,325,44,106,62,40,30,-8,70,106,Beans,Espresso,Caffe Mocha,New Hampshire,40,60,10,100,Regular,-18
2012-12-01T00:00:00,603,East,Small Market,462,48,122,74,15,31,28,46,122,Beans,Coffee,Colombian,New Hampshire,40,60,30,100,Regular,-2
2013-10-01T00:00:00,603,East,Small Market,310,49,120,71,15,7,49,38,128,Beans,Coffee,Amaretto,New Hampshire,30,60,60,90,Regular,-11
2013-10-01T00:00:00,603,East,Small Market,447,45,114,69,14,19,36,45,121,Beans,Coffee,Colombian,New Hampshire,30,60,50,90,Regular,-14
2013-10-01T00:00:00,603,East,Small Market,320,45,109,64,41,33,-10,71,116,Beans,Espresso,Caffe Mocha,New Hampshire,30,60,30,90,Regular,-40
2013-11-01T00:00:00,603,East,Small Market,316,46,113,67,14,8,45,37,120,Beans,Coffee,Amaretto,New Hampshire,40,60,40,100,Regular,5
2013-11-01T00:00:00,603,East,Small Market,452,43,109,66,14,22,30,46,116,Beans,Coffee,Colombian,New Hampshire,30,60,30,90,Regular,0
2013-11-01T00:00:00,603,East,Small Market,325,44,106,62,40,34,-12,70,113,Beans,Espresso,Caffe Mocha,New Hampshire,40,60,10,100,Regular,-22
2013-12-01T00:00:00,603,East,Small Market,462,48,122,74,15,17,42,46,130,Beans,Coffee,Colombian,New Hampshire,40,60,30,100,Regular,12
2012-10-01T00:00:00,603,East,Small Market,430,0,43,43,0,11,32,11,43,Leaves,Tea,Green Tea,New Hampshire,0,40,40,40,Regular,-8
2012-11-01T00:00:00,603,East,Small Market,211,34,76,42,12,33,-3,45,76,Beans,Espresso,Regular Espresso,New Hampshire,30,40,0,70,Regular,-3
2012-11-01T00:00:00,603,East,Small Market,387,0,43,43,0,11,32,11,43,Leaves,Tea,Green Tea,New Hampshire,0,40,30,40,Regular,2
2012-12-01T00:00:00,603,East,Small Market,250,39,88,49,14,33,2,47,88,Leaves,Herbal Tea,Lemon,New Hampshire,20,40,10,60,Decaf,-8
2012-12-01T00:00:00,603,East,Small Market,344,0,43,43,0,11,32,11,43,Leaves,Tea,Green Tea,New Hampshire,0,40,30,40,Regular,2
2013-10-01T00:00:00,603,East,Small Market,430,0,43,43,0,-4,47,11,46,Leaves,Tea,Green Tea,New Hampshire,0,40,40,40,Regular,7
2013-11-01T00:00:00,603,East,Small Market,211,34,76,42,12,34,-4,45,81,Beans,Espresso,Regular Espresso,New Hampshire,30,40,0,70,Regular,-4
2013-11-01T00:00:00,603,East,Small Market,387,0,43,43,0,-4,47,11,46,Leaves,Tea,Green Tea,New Hampshire,0,40,30,40,Regular,17
2013-12-01T00:00:00,603,East,Small Market,250,39,88,49,14,32,3,47,94,Leaves,Herbal Tea,Lemon,New Hampshire,20,40,10,60,Decaf,-7
2013-12-01T00:00:00,603,East,Small Market,344,0,43,43,0,-4,47,11,46,Leaves,Tea,Green Tea,New Hampshire,0,40,30,40,Regular,17
2012-12-01T00:00:00,603,East,Small Market,327,52,127,75,16,22,37,38,127,Beans,Coffee,Amaretto,New Hampshire,40,70,50,110,Regular,-13
2012-12-01T00:00:00,603,East,Small Market,335,49,118,69,44,29,-4,73,118,Beans,Espresso,Caffe Mocha,New Hampshire,40,70,10,110,Regular,-14
2013-12-01T00:00:00,603,East,Small Market,327,52,127,75,16,4,55,38,135,Beans,Coffee,Amaretto,New Hampshire,40,70,50,110,Regular,5
2013-12-01T00:00:00,603,East,Small Market,335,49,118,69,44,31,-6,73,126,Beans,Espresso,Caffe Mocha,New Hampshire,40,70,10,110,Regular,-16
2012-10-01T00:00:00,603,East,Small Market,209,25,56,31,9,34,-12,43,56,Beans,Espresso,Regular Espresso,New Hampshire,10,30,10,40,Regular,-22
2012-10-01T00:00:00,603,East,Small Market,240,34,77,43,12,34,-3,46,77,Leaves,Herbal Tea,Lemon,New Hampshire,10,30,20,40,Decaf,-23
2012-10-01T00:00:00,603,East,Small Market,846,21,52,31,5,12,14,17,52,Leaves,Tea,Darjeeling,New Hampshire,20,30,30,50,Regular,-16
2012-11-01T00:00:00,603,East,Small Market,243,33,74,41,12,33,-4,45,74,Leaves,Herbal Tea,Lemon,New Hampshire,20,30,0,50,Decaf,-4
2012-11-01T00:00:00,603,East,Small Market,848,15,39,24,4,12,8,16,39,Leaves,Tea,Darjeeling,New Hampshire,10,30,20,40,Regular,-12
2012-12-01T00:00:00,603,East,Small Market,218,20,45,25,7,34,-16,41,45,Beans,Espresso,Regular Espresso,New Hampshire,10,30,0,40,Regular,-16
2012-12-01T00:00:00,603,East,Small Market,851,16,41,25,4,11,10,15,41,Leaves,Tea,Darjeeling,New Hampshire,10,30,20,40,Regular,-10
2013-10-01T00:00:00,603,East,Small Market,209,25,56,31,9,40,-18,43,60,Beans,Espresso,Regular Espresso,New Hampshire,10,30,10,40,Regular,-28
2013-10-01T00:00:00,603,East,Small Market,240,34,77,43,12,35,-4,46,82,Leaves,Herbal Tea,Lemon,New Hampshire,10,30,20,40,Decaf,-24
2013-10-01T00:00:00,603,East,Small Market,846,21,52,31,5,5,21,17,55,Leaves,Tea,Darjeeling,New Hampshire,20,30,30,50,Regular,-9
2013-11-01T00:00:00,603,East,Small Market,243,33,74,41,12,35,-6,45,79,Leaves,Herbal Tea,Lemon,New Hampshire,20,30,0,50,Decaf,-6
2013-11-01T00:00:00,603,East,Small Market,848,15,39,24,4,8,12,16,42,Leaves,Tea,Darjeeling,New Hampshire,10,30,20,40,Regular,-8
2013-12-01T00:00:00,603,East,Small Market,218,20,45,25,7,42,-24,41,48,Beans,Espresso,Regular Espresso,New Hampshire,10,30,0,40,Regular,-24
2013-12-01T00:00:00,603,East,Small Market,851,16,41,25,4,6,15,15,44,Leaves,Tea,Darjeeling,New Hampshire,10,30,20,40,Regular,-5
2012-12-01T00:00:00,607,East,Major Market,1727,294,747,453,111,33,309,144,747,Leaves,Herbal Tea,Lemon,New York,220,320,210,540,Decaf,99
2013-10-01T00:00:00,607,East,Major Market,580,76,187,111,21,-26,116,33,199,Leaves,Tea,Green Tea,New York,80,120,100,200,Regular,16
2013-11-01T00:00:00,607,East,Major Market,2580,249,623,374,87,-63,350,138,664,Beans,Coffee,Colombian,New York,220,340,230,560,Regular,120
2013-12-01T00:00:00,608,Central,Small Market,567,24,56,32,7,6,19,19,60,Beans,Espresso,Decaf Espresso,Wisconsin,30,40,30,70,Decaf,-11
2012-10-01T00:00:00,608,Central,Small Market,1055,80,174,94,24,22,48,46,174,Beans,Espresso,Caffe Mocha,Wisconsin,110,140,120,250,Regular,-72
2013-11-01T00:00:00,608,Central,Small Market,694,94,224,130,85,21,24,114,239,Beans,Coffee,Colombian,Wisconsin,90,130,30,220,Regular,-6
2012-11-01T00:00:00,614,Central,Major Market,862,36,88,52,10,12,30,22,88,Leaves,Herbal Tea,Lemon,Ohio,30,50,40,80,Decaf,-10
2012-12-01T00:00:00,614,Central,Major Market,435,41,101,60,13,23,24,36,101,Beans,Coffee,Colombian,Ohio,40,50,20,90,Regular,4
2013-12-01T00:00:00,614,Central,Major Market,490,29,73,44,8,-1,37,19,78,Leaves,Herbal Tea,Chamomile,Ohio,20,40,30,60,Decaf,7
2012-11-01T00:00:00,614,Central,Major Market,424,46,114,68,14,22,32,36,114,Beans,Coffee,Colombian,Ohio,40,70,40,110,Regular,-8
2013-10-01T00:00:00,614,Central,Major Market,405,52,123,71,17,15,39,45,131,Beans,Coffee,Amaretto,Ohio,40,70,60,110,Regular,-21
2013-11-01T00:00:00,614,Central,Major Market,509,52,125,73,47,30,-4,76,133,Beans,Coffee,Decaf Irish Cream,Ohio,50,70,10,120,Decaf,-14
2012-10-01T00:00:00,614,Central,Major Market,404,54,120,66,20,34,12,54,120,Beans,Espresso,Decaf Espresso,Ohio,70,100,70,170,Decaf,-58
2012-10-01T00:00:00,614,Central,Major Market,656,91,218,127,28,23,76,51,218,Leaves,Tea,Earl Grey,Ohio,50,100,80,150,Regular,-4
2013-11-01T00:00:00,614,Central,Major Market,798,78,197,119,25,2,92,57,210,Leaves,Tea,Darjeeling,Ohio,60,100,60,160,Regular,32
2012-11-01T00:00:00,617,East,Major Market,410,55,124,69,20,34,15,54,124,Leaves,Herbal Tea,Lemon,Massachusetts,40,50,20,90,Decaf,-5
2012-12-01T00:00:00,617,East,Major Market,870,33,82,49,9,11,29,20,82,Leaves,Tea,Darjeeling,Massachusetts,30,50,40,80,Regular,-11
2013-11-01T00:00:00,617,East,Major Market,1283,181,363,182,50,-28,160,74,387,Beans,Espresso,Regular Espresso,Massachusetts,170,180,120,350,Regular,40
2013-12-01T00:00:00,618,Central,Major Market,959,123,302,179,34,-52,197,46,322,Leaves,Herbal Tea,Chamomile,Illinois,110,170,130,280,Decaf,67
2012-12-01T00:00:00,619,West,Major Market,601,54,133,79,15,11,53,26,133,Leaves,Tea,Earl Grey,California,30,60,50,90,Regular,3
2012-11-01T00:00:00,619,West,Major Market,2758,113,116,3,36,23,-56,59,116,Beans,Coffee,Amaretto,California,130,0,-50,130,Regular,-6
2013-10-01T00:00:00,626,West,Major Market,580,76,187,111,21,-27,117,32,199,Leaves,Tea,Earl Grey,California,30,50,50,80,Regular,67
2012-10-01T00:00:00,626,West,Major Market,2548,260,650,390,91,52,247,143,650,Beans,Coffee,Colombian,California,380,580,470,960,Regular,-223
2012-12-01T00:00:00,626,West,Major Market,1003,86,210,124,24,11,89,35,210,Leaves,Herbal Tea,Chamomile,California,80,110,80,190,Decaf,9
2013-11-01T00:00:00,626,West,Major Market,3909,173,146,-27,57,104,-188,100,156,Beans,Coffee,Decaf Irish Cream,California,200,-30,-130,170,Decaf,-58
2012-10-01T00:00:00,630,Central,Major Market,541,39,90,51,12,12,27,24,90,Leaves,Herbal Tea,Lemon,Illinois,20,40,40,60,Decaf,-13
2013-12-01T00:00:00,630,Central,Major Market,601,54,133,79,15,-15,79,26,142,Leaves,Tea,Darjeeling,Illinois,40,70,50,110,Regular,29
2012-12-01T00:00:00,630,Central,Major Market,677,67,168,101,22,32,47,54,168,Leaves,Tea,Earl Grey,Illinois,50,80,40,130,Regular,7
2012-11-01T00:00:00,630,Central,Major Market,984,81,198,117,22,11,84,33,198,Leaves,Herbal Tea,Mint,Illinois,70,110,80,180,Decaf,4
2012-11-01T00:00:00,630,Central,Major Market,659,75,189,114,24,31,59,55,189,Leaves,Tea,Earl Grey,Illinois,60,90,50,150,Regular,9
2012-12-01T00:00:00,630,Central,Major Market,830,127,312,185,40,23,122,63,312,Beans,Coffee,Decaf Irish Cream,Illinois,120,180,130,300,Decaf,-8
2012-12-01T00:00:00,630,Central,Major Market,1820,250,501,251,70,24,157,94,501,Beans,Espresso,Decaf Espresso,Illinois,320,320,240,640,Decaf,-83
2012-12-01T00:00:00,630,Central,Major Market,1003,86,210,124,24,12,88,36,210,Leaves,Herbal Tea,Mint,Illinois,80,110,80,190,Decaf,8
2013-11-01T00:00:00,630,Central,Major Market,1691,228,532,304,75,-62,291,108,567,Beans,Espresso,Caffe Mocha,Illinois,290,390,290,680,Regular,1
2012-11-01T00:00:00,631,East,Major Market,1704,245,576,331,93,34,204,127,576,Leaves,Herbal Tea,Lemon,New York,180,240,140,420,Decaf,64
2013-10-01T00:00:00,631,East,Major Market,4360,239,164,-75,74,103,-252,95,175,Leaves,Herbal Tea,Mint,New York,130,-50,-100,80,Decaf,-152
2013-12-01T00:00:00,631,East,Major Market,1727,294,747,453,111,-117,459,144,796,Leaves,Herbal Tea,Lemon,New York,220,320,210,540,Decaf,249
2013-11-01T00:00:00,636,Central,Small Market,836,33,81,48,9,-1,40,21,86,Beans,Espresso,Decaf Espresso,Missouri,40,60,50,100,Decaf,-10
2012-10-01T00:00:00,636,Central,Small Market,244,39,92,53,12,28,13,40,92,Leaves,Tea,Darjeeling,Missouri,20,40,30,60,Regular,-17
2012-11-01T00:00:00,636,Central,Small Market,211,34,76,42,12,33,-3,45,76,Leaves,Tea,Earl Grey,Missouri,20,40,0,60,Regular,-3
2012-12-01T00:00:00,636,Central,Small Market,250,39,88,49,14,33,2,47,88,Leaves,Tea,Green Tea,Missouri,30,40,0,70,Regular,2
2013-11-01T00:00:00,636,Central,Small Market,248,35,82,47,11,23,13,38,87,Leaves,Tea,Darjeeling,Missouri,20,40,10,60,Regular,3
2013-12-01T00:00:00,636,Central,Small Market,1075,63,139,76,19,4,53,40,148,Beans,Coffee,Decaf Irish Cream,Missouri,60,70,40,130,Decaf,13
2013-10-01T00:00:00,636,Central,Small Market,1053,65,142,77,20,5,52,42,151,Beans,Coffee,Decaf Irish Cream,Missouri,50,80,70,130,Decaf,-18
2012-12-01T00:00:00,641,Central,Small Market,344,0,43,43,0,11,32,11,43,Beans,Espresso,Decaf Espresso,Iowa,0,50,40,50,Decaf,-8
2013-10-01T00:00:00,641,Central,Small Market,800,23,58,35,6,2,27,17,62,Beans,Espresso,Caffe Mocha,Iowa,20,50,50,70,Regular,-23
2012-12-01T00:00:00,641,Central,Small Market,851,16,41,25,4,11,10,15,41,Beans,Coffee,Amaretto,Iowa,10,30,20,40,Regular,-10
2013-12-01T00:00:00,641,Central,Small Market,1009,31,69,38,9,17,12,30,74,Beans,Coffee,Colombian,Iowa,30,30,10,60,Regular,2
2012-10-01T00:00:00,641,Central,Small Market,598,10,23,13,3,12,-2,15,23,Beans,Coffee,Decaf Irish Cream,Iowa,0,10,10,10,Decaf,-12
2012-10-01T00:00:00,641,Central,Small Market,789,122,298,176,39,23,114,62,298,Leaves,Herbal Tea,Lemon,Iowa,90,150,130,240,Decaf,-16
2012-11-01T00:00:00,641,Central,Small Market,596,10,23,13,3,13,-3,16,23,Beans,Coffee,Decaf Irish Cream,Iowa,0,20,10,20,Decaf,-13
2012-12-01T00:00:00,641,Central,Small Market,1744,247,576,329,81,32,216,113,576,Leaves,Herbal Tea,Chamomile,Iowa,230,300,200,530,Decaf,16
2012-12-01T00:00:00,641,Central,Small Market,1820,250,501,251,70,25,156,95,501,Leaves,Tea,Darjeeling,Iowa,210,200,120,410,Regular,36
2012-12-01T00:00:00,641,Central,Small Market,1838,294,654,360,111,33,216,144,654,Leaves,Tea,Earl Grey,Iowa,240,300,170,540,Regular,46
2013-10-01T00:00:00,641,Central,Small Market,598,10,23,13,3,13,-3,15,25,Beans,Coffee,Decaf Irish Cream,Iowa,0,10,10,10,Decaf,-13
2013-11-01T00:00:00,641,Central,Small Market,1691,228,532,304,75,-62,291,108,567,Leaves,Herbal Tea,Chamomile,Iowa,210,280,180,490,Decaf,111
2013-11-01T00:00:00,641,Central,Small Market,803,113,278,165,36,-30,159,58,296,Leaves,Herbal Tea,Lemon,Iowa,100,150,100,250,Decaf,59
2013-11-01T00:00:00,641,Central,Small Market,1784,245,545,300,93,-50,257,127,581,Leaves,Tea,Earl Grey,Iowa,200,250,130,450,Regular,127
2013-12-01T00:00:00,641,Central,Small Market,1820,250,501,251,70,-51,232,95,534,Leaves,Tea,Darjeeling,Iowa,210,200,120,410,Regular,112
2012-11-01T00:00:00,646,East,Major Market,933,211,675,464,59,24,381,83,675,Beans,Espresso,Regular Espresso,New York,200,460,390,660,Regular,-9
2012-11-01T00:00:00,650,West,Major Market,589,50,123,73,14,12,47,26,123,Leaves,Tea,Earl Grey,California,30,50,40,80,Regular,7
2012-11-01T00:00:00,650,West,Major Market,659,75,189,114,24,31,59,55,189,Leaves,Tea,Green Tea,California,50,80,40,130,Regular,19
2013-10-01T00:00:00,650,West,Major Market,3654,154,130,-24,50,100,-174,93,139,Beans,Coffee,Decaf Irish Cream,California,220,-30,-100,190,Decaf,-74
2013-12-01T00:00:00,660,Central,Small Market,250,39,88,49,14,32,3,47,94,Leaves,Tea,Green Tea,Missouri,30,40,0,70,Regular,3
2012-10-01T00:00:00,660,Central,Small Market,1053,65,142,77,20,22,35,42,142,Beans,Coffee,Decaf Irish Cream,Missouri,50,80,70,130,Decaf,-35
2012-10-01T00:00:00,660,Central,Small Market,833,32,79,47,8,11,28,19,79,Beans,Espresso,Decaf Espresso,Missouri,30,80,80,110,Decaf,-52
2012-10-01T00:00:00,661,West,Major Market,971,108,265,157,30,12,115,42,265,Leaves,Herbal Tea,Chamomile,California,80,130,120,210,Decaf,-5
2013-12-01T00:00:00,661,West,Major Market,1321,241,525,284,74,-69,279,96,559,Leaves,Herbal Tea,Lemon,California,220,260,170,480,Decaf,109
2012-12-01T00:00:00,682,South,Major Market,531,43,99,56,14,12,30,26,99,Beans,Coffee,Decaf Irish Cream,Texas,50,60,40,110,Decaf,-10
2013-10-01T00:00:00,682,South,Major Market,-868,72,182,110,23,5,82,55,194,Beans,Espresso,Caffe Latte,Texas,40,70,50,110,Regular,32
2013-10-01T00:00:00,702,West,Small Market,240,34,77,43,12,34,-3,45,82,Beans,Coffee,Colombian,Nevada,40,60,30,100,Regular,-33
2013-12-01T00:00:00,702,West,Small Market,250,39,88,49,14,34,1,48,94,Beans,Coffee,Colombian,Nevada,40,60,20,100,Regular,-19
2012-12-01T00:00:00,702,West,Small Market,1009,31,69,38,9,21,8,30,69,Beans,Coffee,Decaf Irish Cream,Nevada,30,50,30,80,Decaf,-22
2012-12-01T00:00:00,702,West,Small Market,344,0,43,43,0,12,31,12,43,Beans,Espresso,Caffe Latte,Nevada,0,40,30,40,Regular,1
2013-11-01T00:00:00,702,West,Small Market,1003,29,64,35,8,20,7,30,68,Beans,Coffee,Decaf Irish Cream,Nevada,30,40,20,70,Decaf,-13
2012-10-01T00:00:00,702,West,Small Market,800,23,58,35,6,12,17,18,58,Beans,Espresso,Decaf Espresso,Nevada,10,30,30,40,Decaf,-13
2012-10-01T00:00:00,702,West,Small Market,430,0,43,43,0,11,32,11,43,Beans,Espresso,Caffe Latte,Nevada,0,30,30,30,Regular,2
2012-12-01T00:00:00,702,West,Small Market,807,23,58,35,6,12,17,18,58,Beans,Espresso,Decaf Espresso,Nevada,20,30,20,50,Decaf,-3
2013-10-01T00:00:00,702,West,Small Market,430,0,43,43,0,-4,47,11,46,Beans,Espresso,Caffe Latte,Nevada,0,30,30,30,Regular,17
2012-10-01T00:00:00,702,West,Small Market,846,21,52,31,5,12,14,17,52,Beans,Espresso,Caffe Mocha,Nevada,10,20,20,30,Regular,-6
2012-10-01T00:00:00,702,West,Small Market,1132,154,367,213,50,43,120,93,367,Leaves,Herbal Tea,Lemon,Nevada,120,170,120,290,Decaf,0
2012-10-01T00:00:00,702,West,Small Market,789,122,298,176,39,23,114,62,298,Leaves,Herbal Tea,Mint,Nevada,90,150,130,240,Decaf,-16
2012-10-01T00:00:00,702,West,Small Market,1662,257,598,341,84,33,224,117,598,Leaves,Tea,Darjeeling,Nevada,110,180,130,290,Regular,94
2012-10-01T00:00:00,702,West,Small Market,7058,255,0,-255,96,12,-363,129,21,Leaves,Tea,Green Tea,Nevada,110,-110,-170,0,Regular,-193
2012-11-01T00:00:00,702,West,Small Market,1150,173,412,239,57,44,138,101,412,Leaves,Herbal Tea,Lemon,Nevada,160,220,130,380,Decaf,8
2012-11-01T00:00:00,702,West,Small Market,803,113,278,165,36,22,107,58,278,Leaves,Herbal Tea,Mint,Nevada,100,150,100,250,Decaf,7
2012-11-01T00:00:00,702,West,Small Market,1691,228,532,304,75,33,196,108,532,Leaves,Tea,Darjeeling,Nevada,160,220,140,380,Regular,56
2012-11-01T00:00:00,702,West,Small Market,1778,211,423,212,59,25,128,84,423,Leaves,Tea,Earl Grey,Nevada,150,150,80,300,Regular,48
2012-11-01T00:00:00,702,West,Small Market,7653,245,0,-245,93,2,-340,127,32,Leaves,Tea,Green Tea,Nevada,180,-180,-280,0,Regular,-60
2012-12-01T00:00:00,702,West,Small Market,940,135,322,187,122,33,32,155,322,Leaves,Herbal Tea,Chamomile,Nevada,120,170,30,290,Decaf,2
2012-12-01T00:00:00,702,West,Small Market,1744,247,576,329,81,33,215,114,576,Leaves,Tea,Darjeeling,Nevada,180,240,150,420,Regular,65
2012-12-01T00:00:00,702,West,Small Market,1820,250,501,251,70,24,157,94,501,Leaves,Tea,Earl Grey,Nevada,180,180,100,360,Regular,57
2013-10-01T00:00:00,702,West,Small Market,898,125,298,173,113,21,39,147,318,Leaves,Herbal Tea,Chamomile,Nevada,90,150,60,240,Decaf,-21
2013-10-01T00:00:00,702,West,Small Market,7058,255,0,-255,96,188,-539,129,22,Leaves,Tea,Green Tea,Nevada,110,-110,-170,0,Regular,-369
2013-11-01T00:00:00,702,West,Small Market,912,121,289,168,109,20,39,142,308,Leaves,Herbal Tea,Chamomile,Nevada,110,150,20,260,Decaf,19
2013-11-01T00:00:00,702,West,Small Market,1150,173,412,239,57,-23,205,101,439,Leaves,Herbal Tea,Lemon,Nevada,160,220,130,380,Decaf,75
2013-11-01T00:00:00,702,West,Small Market,1778,211,423,212,59,-37,190,84,451,Leaves,Tea,Earl Grey,Nevada,150,150,80,300,Regular,110
2013-12-01T00:00:00,702,West,Small Market,940,135,322,187,122,18,47,155,343,Leaves,Herbal Tea,Chamomile,Nevada,120,170,30,290,Decaf,17
2013-12-01T00:00:00,702,West,Small Market,1191,224,534,310,73,-51,288,116,569,Leaves,Herbal Tea,Lemon,Nevada,210,280,170,490,Decaf,118
2012-11-01T00:00:00,707,West,Major Market,536,40,92,52,13,12,27,25,92,Leaves,Herbal Tea,Mint,California,30,50,30,80,Decaf,-3
2012-11-01T00:00:00,707,West,Major Market,1691,228,532,304,75,32,197,107,532,Beans,Espresso,Decaf Espresso,California,220,290,190,510,Decaf,7
2012-12-01T00:00:00,707,West,Major Market,2642,279,699,420,97,52,271,149,699,Beans,Coffee,Colombian,California,330,500,350,830,Regular,-79
2013-11-01T00:00:00,708,Central,Major Market,589,50,123,73,14,-12,71,25,131,Leaves,Tea,Darjeeling,Illinois,40,60,40,100,Regular,31
2013-12-01T00:00:00,708,Central,Major Market,677,67,168,101,22,9,70,54,179,Leaves,Tea,Earl Grey,Illinois,50,80,40,130,Regular,30
2012-10-01T00:00:00,708,Central,Major Market,915,123,302,179,34,12,133,46,302,Leaves,Herbal Tea,Chamomile,Illinois,90,150,140,240,Decaf,-7
2013-10-01T00:00:00,708,Central,Major Market,915,123,302,179,34,-52,197,46,322,Leaves,Herbal Tea,Chamomile,Illinois,90,150,140,240,Decaf,57
2013-11-01T00:00:00,708,Central,Major Market,930,118,290,172,33,-49,188,45,309,Leaves,Herbal Tea,Chamomile,Illinois,110,150,110,260,Decaf,78
2013-11-01T00:00:00,708,Central,Major Market,984,81,198,117,22,-30,125,33,211,Leaves,Herbal Tea,Mint,Illinois,70,110,80,180,Decaf,45
2013-12-01T00:00:00,708,Central,Major Market,1744,247,576,329,81,-73,321,113,614,Beans,Espresso,Caffe Mocha,Illinois,310,420,320,730,Regular,1
2012-10-01T00:00:00,712,Central,Small Market,430,0,43,43,0,12,31,12,43,Beans,Espresso,Decaf Espresso,Iowa,0,60,60,60,Decaf,-29
2012-11-01T00:00:00,712,Central,Small Market,387,0,43,43,0,12,31,12,43,Beans,Espresso,Decaf Espresso,Iowa,0,50,40,50,Decaf,-9
2012-10-01T00:00:00,712,Central,Small Market,1662,257,598,341,84,33,224,117,598,Leaves,Herbal Tea,Chamomile,Iowa,200,280,210,480,Decaf,14
2012-11-01T00:00:00,712,Central,Small Market,1691,228,532,304,75,33,196,108,532,Leaves,Herbal Tea,Chamomile,Iowa,210,280,180,490,Decaf,16
2012-11-01T00:00:00,712,Central,Small Market,803,113,278,165,36,22,107,58,278,Leaves,Herbal Tea,Lemon,Iowa,100,150,100,250,Decaf,7
2012-11-01T00:00:00,712,Central,Small Market,1778,211,423,212,59,24,129,83,423,Leaves,Tea,Darjeeling,Iowa,170,180,110,350,Regular,19
2013-11-01T00:00:00,712,Central,Small Market,848,15,39,24,4,8,12,16,42,Beans,Coffee,Amaretto,Iowa,10,20,10,30,Regular,2
2013-12-01T00:00:00,712,Central,Small Market,594,10,24,14,3,12,-1,15,26,Beans,Coffee,Decaf Irish Cream,Iowa,0,20,10,20,Decaf,-11
2012-11-01T00:00:00,713,South,Major Market,411,59,138,79,19,28,32,47,138,Leaves,Herbal Tea,Chamomile,Texas,50,70,40,120,Decaf,-8
2012-10-01T00:00:00,713,South,Major Market,405,52,123,71,17,28,26,45,123,Leaves,Herbal Tea,Chamomile,Texas,30,80,70,110,Decaf,-44
2012-10-01T00:00:00,714,West,Major Market,1662,257,598,341,84,32,225,116,598,Beans,Espresso,Decaf Espresso,California,230,320,240,550,Decaf,-15
2012-12-01T00:00:00,714,West,Major Market,4216,224,192,-32,73,44,-149,117,192,Beans,Coffee,Decaf Irish Cream,California,260,-40,-150,220,Decaf,1
2013-10-01T00:00:00,714,West,Major Market,1755,239,478,239,66,-48,221,90,509,Beans,Espresso,Caffe Latte,California,210,220,160,430,Regular,61
2012-10-01T00:00:00,715,Central,Small Market,573,22,51,29,7,12,10,19,51,Beans,Espresso,Decaf Espresso,Wisconsin,20,50,50,70,Decaf,-40
2012-10-01T00:00:00,715,Central,Small Market,606,60,144,84,54,30,0,84,144,Leaves,Tea,Earl Grey,Wisconsin,40,50,0,90,Regular,0
2013-11-01T00:00:00,715,Central,Small Market,856,31,78,47,8,-1,40,20,83,Leaves,Herbal Tea,Lemon,Wisconsin,20,50,40,70,Decaf,0
2013-11-01T00:00:00,715,Central,Small Market,454,49,120,71,15,7,49,38,128,Leaves,Tea,Darjeeling,Wisconsin,40,50,20,90,Regular,29
2012-11-01T00:00:00,715,Central,Small Market,570,22,52,30,7,12,11,19,52,Beans,Espresso,Decaf Espresso,Wisconsin,20,40,30,60,Decaf,-19
2012-12-01T00:00:00,715,Central,Small Market,863,34,85,51,9,12,30,21,85,Leaves,Herbal Tea,Lemon,Wisconsin,30,40,30,70,Decaf,0
2013-12-01T00:00:00,715,Central,Small Market,863,34,85,51,9,-3,45,21,91,Leaves,Herbal Tea,Lemon,Wisconsin,30,40,30,70,Decaf,15
2012-11-01T00:00:00,715,Central,Small Market,613,61,147,86,55,29,2,84,147,Leaves,Tea,Earl Grey,Wisconsin,50,70,0,120,Regular,2
2013-11-01T00:00:00,715,Central,Small Market,613,61,147,86,55,28,3,84,157,Leaves,Tea,Earl Grey,Wisconsin,50,70,0,120,Regular,3
2012-10-01T00:00:00,715,Central,Small Market,385,56,126,70,21,34,15,55,126,Beans,Coffee,Amaretto,Wisconsin,40,80,50,120,Regular,-35
2012-12-01T00:00:00,715,Central,Small Market,403,65,145,80,24,34,22,58,145,Beans,Coffee,Amaretto,Wisconsin,60,80,30,140,Regular,-8
2013-10-01T00:00:00,715,Central,Small Market,329,60,159,99,18,-4,85,42,169,Leaves,Herbal Tea,Chamomile,Wisconsin,40,80,80,120,Decaf,5
2012-10-01T00:00:00,715,Central,Small Market,547,86,202,116,28,27,61,55,202,Beans,Coffee,Decaf Irish Cream,Wisconsin,80,120,100,200,Decaf,-39
2012-10-01T00:00:00,715,Central,Small Market,683,96,230,134,87,29,18,116,230,Beans,Coffee,Colombian,Wisconsin,90,140,60,230,Regular,-42
2012-12-01T00:00:00,715,Central,Small Market,575,83,195,112,27,28,57,55,195,Beans,Coffee,Decaf Irish Cream,Wisconsin,80,110,70,190,Decaf,-13
2012-12-01T00:00:00,715,Central,Small Market,716,105,250,145,95,30,20,125,250,Beans,Coffee,Colombian,Wisconsin,100,140,30,240,Regular,-10
2012-12-01T00:00:00,715,Central,Small Market,1079,80,176,96,24,22,50,46,176,Beans,Espresso,Caffe Mocha,Wisconsin,100,120,80,220,Regular,-30
2013-11-01T00:00:00,715,Central,Small Market,1063,75,164,89,23,-1,67,44,175,Beans,Espresso,Caffe Mocha,Wisconsin,90,110,70,200,Regular,-3
2012-10-01T00:00:00,716,East,Major Market,915,123,302,179,34,11,134,45,302,Leaves,Tea,Earl Grey,New York,130,190,160,320,Regular,-26
2012-12-01T00:00:00,716,East,Major Market,5121,241,148,-93,74,22,-189,96,148,Leaves,Herbal Tea,Mint,New York,180,-80,-150,100,Decaf,-39
2012-12-01T00:00:00,716,East,Major Market,1003,86,210,124,24,11,89,35,210,Leaves,Tea,Darjeeling,New York,90,120,90,210,Regular,-1
2013-10-01T00:00:00,716,East,Major Market,2548,260,650,390,91,-68,367,143,693,Beans,Coffee,Colombian,New York,210,330,230,540,Regular,137
2013-12-01T00:00:00,716,East,Major Market,5121,241,148,-93,74,113,-280,96,158,Leaves,Herbal Tea,Mint,New York,180,-80,-150,100,Decaf,-130
2012-11-01T00:00:00,718,East,Major Market,589,50,123,73,14,12,47,26,123,Leaves,Tea,Green Tea,New York,50,70,50,120,Regular,-3
2012-10-01T00:00:00,718,East,Major Market,1197,239,765,526,66,25,435,91,765,Beans,Espresso,Regular Espresso,New York,210,510,450,720,Regular,-15
2012-12-01T00:00:00,718,East,Major Market,723,250,657,407,70,25,312,95,657,Beans,Espresso,Regular Espresso,New York,240,400,320,640,Regular,-8
2012-12-01T00:00:00,718,East,Major Market,959,123,302,179,34,12,133,46,302,Leaves,Tea,Earl Grey,New York,120,190,150,310,Regular,-17
2013-10-01T00:00:00,718,East,Major Market,915,123,302,179,34,-54,199,45,322,Leaves,Tea,Earl Grey,New York,130,190,160,320,Regular,39
2013-12-01T00:00:00,718,East,Major Market,1003,86,210,124,24,-32,132,35,224,Leaves,Tea,Darjeeling,New York,90,120,90,210,Regular,42
2012-11-01T00:00:00,719,Central,Major Market,410,55,124,69,20,34,15,54,124,Leaves,Tea,Darjeeling,Colorado,40,60,20,100,Regular,-5
2012-11-01T00:00:00,719,Central,Major Market,1042,57,125,68,17,22,29,39,125,Leaves,Tea,Earl Grey,Colorado,40,60,30,100,Regular,-1
2013-11-01T00:00:00,719,Central,Major Market,536,40,92,52,13,-1,40,25,98,Beans,Coffee,Colombian,Colorado,30,60,40,90,Regular,0
2013-11-01T00:00:00,719,Central,Major Market,410,55,124,69,20,27,22,54,132,Leaves,Tea,Darjeeling,Colorado,40,60,20,100,Regular,2
2013-11-01T00:00:00,719,Central,Major Market,1042,57,125,68,17,8,43,39,133,Leaves,Tea,Earl Grey,Colorado,40,60,30,100,Regular,13
2013-12-01T00:00:00,719,Central,Major Market,521,47,112,65,42,32,-9,71,119,Leaves,Herbal Tea,Lemon,Colorado,40,60,0,100,Decaf,-9
2012-10-01T00:00:00,719,Central,Major Market,541,39,90,51,12,12,27,24,90,Beans,Coffee,Colombian,Colorado,30,50,50,80,Regular,-23
2012-10-01T00:00:00,719,Central,Major Market,971,108,265,157,30,11,116,41,265,Beans,Coffee,Decaf Irish Cream,Colorado,100,160,150,260,Decaf,-34
2012-10-01T00:00:00,719,Central,Major Market,1267,161,322,161,45,24,92,69,322,Leaves,Herbal Tea,Chamomile,Colorado,120,140,110,260,Decaf,-18
2012-11-01T00:00:00,719,Central,Major Market,561,88,200,112,29,13,70,42,200,Leaves,Tea,Green Tea,Colorado,70,90,60,160,Regular,10
2012-12-01T00:00:00,719,Central,Major Market,959,123,302,179,34,11,134,45,302,Beans,Coffee,Amaretto,Colorado,120,170,130,290,Regular,4
2012-12-01T00:00:00,719,Central,Major Market,551,81,185,104,26,12,66,38,185,Leaves,Tea,Green Tea,Colorado,60,90,60,150,Regular,6
2013-10-01T00:00:00,719,Central,Major Market,971,108,265,157,30,-45,172,41,282,Beans,Coffee,Decaf Irish Cream,Colorado,100,160,150,260,Decaf,22
2013-10-01T00:00:00,719,Central,Major Market,915,123,302,179,34,-52,197,46,322,Beans,Coffee,Amaretto,Colorado,120,180,160,300,Regular,37
2013-11-01T00:00:00,719,Central,Major Market,930,118,290,172,33,-51,190,44,309,Beans,Coffee,Amaretto,Colorado,110,170,130,280,Regular,60
2013-12-01T00:00:00,719,Central,Major Market,551,81,185,104,26,-20,98,38,197,Leaves,Tea,Green Tea,Colorado,60,90,60,150,Regular,38
2013-10-01T00:00:00,720,Central,Major Market,503,51,122,71,46,32,-7,76,130,Leaves,Herbal Tea,Lemon,Colorado,30,60,30,90,Decaf,-37
2013-10-01T00:00:00,720,Central,Major Market,404,54,120,66,20,27,19,53,128,Leaves,Tea,Darjeeling,Colorado,30,50,30,80,Regular,-11
2012-11-01T00:00:00,720,Central,Major Market,411,59,138,79,19,28,32,47,138,Leaves,Herbal Tea,Mint,Colorado,50,70,40,120,Decaf,-8
2012-10-01T00:00:00,720,Central,Major Market,572,90,205,115,29,12,74,41,205,Leaves,Tea,Green Tea,Colorado,50,90,80,140,Regular,-6
2012-12-01T00:00:00,720,Central,Major Market,1003,86,210,124,24,12,88,36,210,Beans,Coffee,Decaf Irish Cream,Colorado,80,120,90,200,Decaf,-2
2013-10-01T00:00:00,720,Central,Major Market,1267,161,322,161,45,-21,137,69,343,Leaves,Herbal Tea,Chamomile,Colorado,120,140,110,260,Decaf,27
2013-11-01T00:00:00,720,Central,Major Market,984,81,198,117,22,-30,125,33,211,Beans,Coffee,Decaf Irish Cream,Colorado,80,110,80,190,Decaf,45
2013-12-01T00:00:00,720,Central,Major Market,1003,86,210,124,24,-31,131,36,224,Beans,Coffee,Decaf Irish Cream,Colorado,80,120,90,200,Decaf,41
2013-12-01T00:00:00,720,Central,Major Market,677,67,168,101,22,9,70,54,179,Beans,Espresso,Decaf Espresso,Colorado,80,130,80,210,Decaf,-10
2013-10-01T00:00:00,727,East,Major Market,683,96,230,134,87,20,27,116,245,Beans,Espresso,Caffe Mocha,Florida,80,130,50,210,Regular,-23
2013-11-01T00:00:00,727,East,Major Market,570,22,52,30,7,7,16,19,55,Leaves,Herbal Tea,Chamomile,Florida,10,20,10,30,Decaf,6
2013-12-01T00:00:00,727,East,Major Market,690,134,320,186,41,-36,181,64,341,Beans,Coffee,Decaf Irish Cream,Florida,120,160,110,280,Decaf,71
2012-12-01T00:00:00,740,Central,Major Market,422,46,103,57,17,34,6,51,103,Beans,Espresso,Decaf Espresso,Ohio,50,80,40,130,Decaf,-34
2012-12-01T00:00:00,740,Central,Major Market,1319,153,306,153,42,24,87,66,306,Beans,Espresso,Caffe Mocha,Ohio,190,200,140,390,Regular,-53
2012-12-01T00:00:00,740,Central,Major Market,690,134,320,186,41,24,121,65,320,Leaves,Tea,Earl Grey,Ohio,110,150,90,260,Regular,31
2013-11-01T00:00:00,740,Central,Major Market,666,102,245,143,31,-20,132,54,261,Leaves,Tea,Earl Grey,Ohio,80,120,70,200,Regular,62
2012-11-01T00:00:00,754,East,Major Market,798,78,197,119,25,31,63,56,197,Beans,Coffee,Colombian,Florida,70,100,60,170,Regular,3
2012-11-01T00:00:00,754,East,Major Market,694,94,224,130,85,30,15,115,224,Beans,Espresso,Caffe Mocha,Florida,90,120,20,210,Regular,-5
2012-12-01T00:00:00,754,East,Major Market,817,88,221,133,29,31,73,60,221,Beans,Coffee,Colombian,Florida,70,120,80,190,Regular,-7
2013-11-01T00:00:00,760,West,Major Market,589,50,123,73,14,-11,70,26,131,Leaves,Tea,Earl Grey,California,30,50,40,80,Regular,30
2013-11-01T00:00:00,760,West,Major Market,984,81,198,117,22,-30,125,33,211,Leaves,Herbal Tea,Chamomile,California,70,110,80,180,Decaf,45
2013-10-01T00:00:00,772,East,Major Market,851,48,118,70,13,-11,68,24,126,Leaves,Tea,Green Tea,Florida,50,70,60,120,Regular,8
2012-12-01T00:00:00,772,East,Major Market,567,24,56,32,7,13,12,20,56,Leaves,Herbal Tea,Chamomile,Florida,10,30,20,40,Decaf,-8
2012-11-01T00:00:00,772,East,Major Market,666,102,245,143,31,23,89,54,245,Beans,Coffee,Decaf Irish Cream,Florida,90,130,90,220,Decaf,-1
2013-10-01T00:00:00,772,East,Major Market,656,91,218,127,28,-14,113,51,232,Beans,Coffee,Decaf Irish Cream,Florida,70,110,90,180,Decaf,23
2013-11-01T00:00:00,772,East,Major Market,557,77,180,103,25,2,76,52,192,Beans,Espresso,Decaf Espresso,Florida,70,100,60,170,Decaf,16
2012-11-01T00:00:00,773,Central,Major Market,536,40,92,52,13,12,27,25,92,Leaves,Herbal Tea,Lemon,Illinois,30,50,30,80,Decaf,-3
2012-12-01T00:00:00,773,Central,Major Market,531,43,99,56,14,13,29,27,99,Leaves,Herbal Tea,Lemon,Illinois,40,50,30,90,Decaf,-1
2013-10-01T00:00:00,773,Central,Major Market,1755,239,478,239,66,-48,221,90,509,Beans,Espresso,Decaf Espresso,Illinois,340,370,300,710,Decaf,-79
2013-12-01T00:00:00,773,Central,Major Market,1820,250,501,251,70,-52,233,94,534,Beans,Espresso,Decaf Espresso,Illinois,320,320,240,640,Decaf,-7
2012-11-01T00:00:00,774,East,Major Market,554,52,120,68,47,29,-8,76,120,Beans,Espresso,Caffe Mocha,Massachusetts,50,60,0,110,Regular,-8
2013-12-01T00:00:00,774,East,Major Market,422,46,103,57,17,30,10,50,110,Leaves,Herbal Tea,Lemon,Massachusetts,30,40,10,70,Decaf,0
2013-12-01T00:00:00,774,East,Major Market,490,29,73,44,8,-1,37,19,78,Leaves,Tea,Green Tea,Massachusetts,30,40,30,70,Regular,7
2012-10-01T00:00:00,774,East,Major Market,542,51,116,65,46,30,-11,76,116,Beans,Espresso,Caffe Mocha,Massachusetts,30,70,30,100,Regular,-41
2013-10-01T00:00:00,774,East,Major Market,542,51,116,65,46,35,-16,76,124,Beans,Espresso,Caffe Mocha,Massachusetts,30,70,30,100,Regular,-46
2012-10-01T00:00:00,775,West,Small Market,1000,31,68,37,9,21,7,30,68,Beans,Coffee,Decaf Irish Cream,Nevada,30,60,50,90,Decaf,-43
2012-10-01T00:00:00,775,West,Small Market,240,34,77,43,12,33,-2,45,77,Beans,Coffee,Colombian,Nevada,40,60,30,100,Regular,-32
2012-12-01T00:00:00,775,West,Small Market,250,39,88,49,14,34,1,48,88,Beans,Coffee,Colombian,Nevada,40,60,20,100,Regular,-19
2013-10-01T00:00:00,775,West,Small Market,1000,31,68,37,9,18,10,30,72,Beans,Coffee,Decaf Irish Cream,Nevada,30,60,50,90,Decaf,-40
2012-11-01T00:00:00,775,West,Small Market,243,33,74,41,12,33,-4,45,74,Beans,Coffee,Colombian,Nevada,30,50,10,80,Regular,-14
2013-11-01T00:00:00,775,West,Small Market,243,33,74,41,12,35,-6,45,79,Beans,Coffee,Colombian,Nevada,30,50,10,80,Regular,-16
2013-12-01T00:00:00,775,West,Small Market,1009,31,69,38,9,17,12,30,74,Beans,Coffee,Decaf Irish Cream,Nevada,30,50,30,80,Decaf,-18
2012-11-01T00:00:00,775,West,Small Market,1003,29,64,35,8,22,5,30,64,Beans,Coffee,Decaf Irish Cream,Nevada,30,40,20,70,Decaf,-15
2012-11-01T00:00:00,775,West,Small Market,387,0,43,43,0,12,31,12,43,Beans,Espresso,Caffe Latte,Nevada,0,40,30,40,Regular,1
2013-11-01T00:00:00,775,West,Small Market,387,0,43,43,0,-3,46,12,46,Beans,Espresso,Caffe Latte,Nevada,0,40,30,40,Regular,16
2013-12-01T00:00:00,775,West,Small Market,344,0,43,43,0,-3,46,12,46,Beans,Espresso,Caffe Latte,Nevada,0,40,30,40,Regular,16
2012-11-01T00:00:00,775,West,Small Market,802,22,56,34,6,11,17,17,56,Beans,Espresso,Decaf Espresso,Nevada,20,30,20,50,Decaf,-3
2013-10-01T00:00:00,775,West,Small Market,800,23,58,35,6,4,25,18,62,Beans,Espresso,Decaf Espresso,Nevada,10,30,30,40,Decaf,-5
2013-11-01T00:00:00,775,West,Small Market,802,22,56,34,6,3,25,17,60,Beans,Espresso,Decaf Espresso,Nevada,20,30,20,50,Decaf,5
2013-12-01T00:00:00,775,West,Small Market,807,23,58,35,6,4,25,18,62,Beans,Espresso,Decaf Espresso,Nevada,20,30,20,50,Decaf,5
2012-10-01T00:00:00,775,West,Small Market,898,125,298,173,113,34,26,147,298,Leaves,Herbal Tea,Chamomile,Nevada,90,150,60,240,Decaf,-34
2012-10-01T00:00:00,775,West,Small Market,1755,239,478,239,66,24,149,90,478,Leaves,Tea,Earl Grey,Nevada,110,120,80,230,Regular,69
2012-11-01T00:00:00,775,West,Small Market,848,15,39,24,4,11,9,15,39,Beans,Espresso,Caffe Mocha,Nevada,10,20,10,30,Regular,-1
2012-11-01T00:00:00,775,West,Small Market,912,121,289,168,109,33,26,142,289,Leaves,Herbal Tea,Chamomile,Nevada,110,150,20,260,Decaf,6
2012-12-01T00:00:00,775,West,Small Market,851,16,41,25,4,11,10,15,41,Beans,Espresso,Caffe Mocha,Nevada,10,20,10,30,Regular,0
2012-12-01T00:00:00,775,West,Small Market,1191,224,534,310,73,43,194,116,534,Leaves,Herbal Tea,Lemon,Nevada,210,280,170,490,Decaf,24
2012-12-01T00:00:00,775,West,Small Market,830,127,312,185,40,23,122,63,312,Leaves,Herbal Tea,Mint,Nevada,120,170,120,290,Decaf,2
2012-12-01T00:00:00,775,West,Small Market,8252,294,0,-294,111,3,-408,145,31,Leaves,Tea,Green Tea,Nevada,210,-210,-320,0,Regular,-88
2013-10-01T00:00:00,775,West,Small Market,846,21,52,31,5,5,21,17,55,Beans,Espresso,Caffe Mocha,Nevada,10,20,20,30,Regular,1
2013-10-01T00:00:00,775,West,Small Market,1132,154,367,213,50,-15,178,93,391,Leaves,Herbal Tea,Lemon,Nevada,120,170,120,290,Decaf,58
2013-10-01T00:00:00,775,West,Small Market,789,122,298,176,39,-32,169,62,318,Leaves,Herbal Tea,Mint,Nevada,90,150,130,240,Decaf,39
2013-10-01T00:00:00,775,West,Small Market,1662,257,598,341,84,-75,332,117,637,Leaves,Tea,Darjeeling,Nevada,110,180,130,290,Regular,202
2013-10-01T00:00:00,775,West,Small Market,1755,239,478,239,66,-48,221,90,509,Leaves,Tea,Earl Grey,Nevada,110,120,80,230,Regular,141
2013-11-01T00:00:00,775,West,Small Market,848,15,39,24,4,7,13,15,42,Beans,Espresso,Caffe Mocha,Nevada,10,20,10,30,Regular,3
2013-11-01T00:00:00,775,West,Small Market,803,113,278,165,36,-30,159,58,296,Leaves,Herbal Tea,Mint,Nevada,100,150,100,250,Decaf,59
2013-11-01T00:00:00,775,West,Small Market,1691,228,532,304,75,-62,291,108,567,Leaves,Tea,Darjeeling,Nevada,160,220,140,380,Regular,151
2013-11-01T00:00:00,775,West,Small Market,7653,245,0,-245,93,167,-505,127,34,Leaves,Tea,Green Tea,Nevada,180,-180,-280,0,Regular,-225
2013-12-01T00:00:00,775,West,Small Market,851,16,41,25,4,6,15,15,44,Beans,Espresso,Caffe Mocha,Nevada,10,20,10,30,Regular,5
2013-12-01T00:00:00,775,West,Small Market,830,127,312,185,40,-36,181,63,332,Leaves,Herbal Tea,Mint,Nevada,120,170,120,290,Decaf,61
2013-12-01T00:00:00,775,West,Small Market,1744,247,576,329,81,-71,319,114,614,Leaves,Tea,Darjeeling,Nevada,180,240,150,420,Regular,169
2013-12-01T00:00:00,775,West,Small Market,1820,250,501,251,70,-52,233,94,534,Leaves,Tea,Earl Grey,Nevada,180,180,100,360,Regular,133
2013-12-01T00:00:00,775,West,Small Market,8252,294,0,-294,111,200,-605,145,33,Leaves,Tea,Green Tea,Nevada,210,-210,-320,0,Regular,-285
2012-10-01T00:00:00,781,East,Major Market,404,54,120,66,20,33,13,53,120,Leaves,Herbal Tea,Lemon,Massachusetts,30,30,20,60,Decaf,-7
2013-10-01T00:00:00,781,East,Major Market,480,21,53,32,5,5,22,17,56,Leaves,Tea,Green Tea,Massachusetts,20,30,30,50,Regular,-8
2012-10-01T00:00:00,781,East,Major Market,1267,161,322,161,45,24,92,69,322,Beans,Espresso,Regular Espresso,Massachusetts,140,160,120,300,Regular,-28
2013-10-01T00:00:00,786,East,Major Market,385,56,126,70,21,25,24,54,134,Leaves,Herbal Tea,Lemon,Florida,30,30,20,60,Decaf,4
2013-11-01T00:00:00,786,East,Major Market,798,78,197,119,25,1,93,56,210,Beans,Coffee,Colombian,Florida,70,100,60,170,Regular,33
2012-10-01T00:00:00,801,West,Small Market,310,49,120,71,15,23,33,38,120,Leaves,Herbal Tea,Chamomile,Utah,30,60,60,90,Decaf,-27
2012-11-01T00:00:00,801,West,Small Market,316,46,113,67,14,23,30,37,113,Leaves,Herbal Tea,Chamomile,Utah,40,60,30,100,Decaf,0
2013-10-01T00:00:00,801,West,Small Market,310,49,120,71,15,7,49,38,128,Leaves,Herbal Tea,Chamomile,Utah,30,60,60,90,Decaf,-11
2012-10-01T00:00:00,801,West,Small Market,833,32,79,47,8,11,28,19,79,Beans,Espresso,Caffe Latte,Utah,20,40,40,60,Regular,-12
2012-10-01T00:00:00,801,West,Small Market,320,45,109,64,41,29,-6,70,109,Leaves,Tea,Darjeeling,Utah,10,40,20,50,Regular,-26
2012-11-01T00:00:00,801,West,Small Market,1804,82,122,40,25,23,-8,48,122,Leaves,Herbal Tea,Mint,Utah,70,40,0,110,Decaf,-8
2012-12-01T00:00:00,801,West,Small Market,256,38,89,51,12,27,12,39,89,Leaves,Tea,Earl Grey,Utah,20,40,10,60,Regular,2
2012-12-01T00:00:00,801,West,Small Market,462,48,122,74,15,31,28,46,122,Leaves,Herbal Tea,Lemon,Utah,40,70,40,110,Decaf,-12
2012-11-01T00:00:00,801,West,Small Market,211,34,76,42,12,33,-3,45,76,Leaves,Tea,Green Tea,Utah,20,30,0,50,Regular,-3
2012-12-01T00:00:00,801,West,Small Market,392,49,114,65,16,28,21,44,114,Beans,Coffee,Colombian,Utah,50,80,50,130,Regular,-29
2012-10-01T00:00:00,801,West,Small Market,564,103,236,133,33,13,87,46,236,Beans,Espresso,Caffe Mocha,Utah,80,130,110,210,Regular,-23
2012-11-01T00:00:00,801,West,Small Market,601,82,184,102,31,33,38,64,184,Beans,Coffee,Decaf Irish Cream,Utah,90,120,60,210,Decaf,-22
2012-11-01T00:00:00,801,West,Small Market,1060,69,150,81,21,21,39,42,150,Beans,Coffee,Amaretto,Utah,80,90,50,170,Regular,-11
2013-11-01T00:00:00,801,West,Small Market,552,101,231,130,33,-29,126,45,246,Beans,Espresso,Caffe Mocha,Utah,90,130,90,220,Regular,36
2013-12-01T00:00:00,801,West,Small Market,619,68,153,85,25,21,39,59,163,Beans,Coffee,Decaf Irish Cream,Utah,80,100,50,180,Decaf,-11
2012-12-01T00:00:00,805,West,Major Market,531,43,99,56,14,13,29,27,99,Leaves,Herbal Tea,Mint,California,40,50,30,90,Decaf,-1
2013-10-01T00:00:00,805,West,Major Market,898,125,298,173,113,20,40,146,318,Beans,Espresso,Caffe Mocha,California,110,160,50,270,Regular,-10
2013-11-01T00:00:00,805,West,Major Market,930,118,290,172,33,-51,190,44,309,Leaves,Tea,Darjeeling,California,80,130,110,210,Regular,80
2013-11-01T00:00:00,806,South,Major Market,424,46,114,68,14,8,46,37,121,Leaves,Herbal Tea,Lemon,Texas,40,60,30,100,Decaf,16
2013-11-01T00:00:00,806,South,Major Market,-1050,75,189,114,24,2,88,55,201,Beans,Espresso,Caffe Latte,Texas,50,90,40,140,Regular,48
2012-12-01T00:00:00,813,East,Major Market,882,30,75,45,8,11,26,19,75,Leaves,Tea,Darjeeling,Florida,30,40,30,70,Regular,-4
2012-12-01T00:00:00,813,East,Major Market,690,134,320,186,41,23,122,64,320,Beans,Coffee,Decaf Irish Cream,Florida,120,160,110,280,Decaf,12
2013-11-01T00:00:00,813,East,Major Market,694,94,224,130,85,23,22,115,239,Beans,Espresso,Caffe Mocha,Florida,90,120,20,210,Regular,2
2013-10-01T00:00:00,815,Central,Major Market,580,76,187,111,21,-26,116,33,199,Leaves,Tea,Darjeeling,Illinois,50,80,80,130,Regular,36
2013-10-01T00:00:00,815,Central,Major Market,650,72,182,110,23,5,82,55,194,Leaves,Tea,Earl Grey,Illinois,50,80,50,130,Regular,32
2012-10-01T00:00:00,815,Central,Major Market,789,122,298,176,39,22,115,61,298,Beans,Coffee,Decaf Irish Cream,Illinois,110,190,160,300,Decaf,-45
2012-10-01T00:00:00,815,Central,Major Market,1132,154,367,213,50,43,120,93,367,Beans,Coffee,Colombian,Illinois,150,220,160,370,Regular,-40
2012-10-01T00:00:00,815,Central,Major Market,1662,257,598,341,84,33,224,117,598,Beans,Espresso,Caffe Mocha,Illinois,370,520,420,890,Regular,-196
2012-10-01T00:00:00,815,Central,Major Market,971,108,265,157,30,11,116,41,265,Leaves,Herbal Tea,Mint,Illinois,80,130,120,210,Decaf,-4
2012-11-01T00:00:00,815,Central,Major Market,803,113,278,165,36,23,106,59,278,Beans,Coffee,Decaf Irish Cream,Illinois,110,160,110,270,Decaf,-4
2012-11-01T00:00:00,815,Central,Major Market,1150,173,412,239,57,43,139,100,412,Beans,Coffee,Colombian,Illinois,170,230,140,400,Regular,-1
2012-12-01T00:00:00,815,Central,Major Market,1744,247,576,329,81,32,216,113,576,Beans,Espresso,Caffe Mocha,Illinois,310,420,320,730,Regular,-104
2013-10-01T00:00:00,815,Central,Major Market,789,122,298,176,39,-34,171,61,318,Beans,Coffee,Decaf Irish Cream,Illinois,110,190,160,300,Decaf,11
2013-10-01T00:00:00,815,Central,Major Market,1132,154,367,213,50,-15,178,93,391,Beans,Coffee,Colombian,Illinois,150,220,160,370,Regular,18
2013-10-01T00:00:00,815,Central,Major Market,971,108,265,157,30,-45,172,41,282,Leaves,Herbal Tea,Mint,Illinois,80,130,120,210,Decaf,52
2013-11-01T00:00:00,815,Central,Major Market,1150,173,412,239,57,-24,206,100,439,Beans,Coffee,Colombian,Illinois,170,230,140,400,Regular,66
2013-12-01T00:00:00,816,Central,Small Market,844,31,77,46,8,-2,40,19,82,Beans,Espresso,Decaf Espresso,Missouri,30,60,50,90,Decaf,-10
2012-12-01T00:00:00,816,Central,Small Market,1075,63,139,76,19,21,36,40,139,Beans,Coffee,Decaf Irish Cream,Missouri,60,70,40,130,Decaf,-4
2012-10-01T00:00:00,816,Central,Small Market,593,79,177,98,30,33,35,63,177,Beans,Coffee,Colombian,Missouri,70,100,70,170,Regular,-35
2013-12-01T00:00:00,816,Central,Small Market,218,20,45,25,7,42,-24,41,48,Leaves,Tea,Earl Grey,Missouri,10,20,-10,30,Regular,-14
2012-11-01T00:00:00,817,South,Major Market,-1050,75,189,114,24,31,59,55,189,Beans,Espresso,Caffe Latte,Texas,50,90,40,140,Regular,19
2013-10-01T00:00:00,817,South,Major Market,915,123,302,179,34,-52,197,46,322,Beans,Espresso,Caffe Mocha,Texas,70,120,100,190,Regular,97
2012-10-01T00:00:00,818,West,Major Market,2555,122,109,-13,39,22,-74,61,109,Beans,Coffee,Amaretto,California,170,-20,-60,150,Regular,-14
2012-11-01T00:00:00,818,West,Major Market,912,121,289,168,109,33,26,142,289,Beans,Espresso,Caffe Mocha,California,110,170,40,280,Regular,-14
2013-10-01T00:00:00,818,West,Major Market,2548,260,650,390,91,-68,367,143,693,Beans,Coffee,Colombian,California,380,580,470,960,Regular,-103
2013-10-01T00:00:00,831,West,Major Market,915,123,302,179,34,-54,199,45,322,Leaves,Tea,Darjeeling,California,50,90,80,140,Regular,119
2012-10-01T00:00:00,832,South,Major Market,-868,72,182,110,23,32,55,55,182,Beans,Espresso,Caffe Latte,Texas,40,70,50,110,Regular,5
2012-10-01T00:00:00,845,East,Major Market,3142,125,69,-56,113,33,-202,146,69,Beans,Espresso,Caffe Mocha,New York,110,-60,-170,50,Regular,-32
2012-10-01T00:00:00,845,East,Major Market,1622,255,513,258,96,33,129,129,513,Leaves,Herbal Tea,Lemon,New York,140,150,70,290,Decaf,59
2012-12-01T00:00:00,845,East,Major Market,2642,279,699,420,97,52,271,149,699,Beans,Coffee,Colombian,New York,250,370,250,620,Regular,21
2013-12-01T00:00:00,845,East,Major Market,3641,135,66,-69,122,141,-332,155,70,Beans,Espresso,Caffe Mocha,New York,130,-70,-210,60,Regular,-122
2012-11-01T00:00:00,847,Central,Major Market,589,50,123,73,14,11,48,25,123,Leaves,Tea,Darjeeling,Illinois,40,60,40,100,Regular,8
2012-10-01T00:00:00,847,Central,Major Market,650,72,182,110,23,32,55,55,182,Leaves,Tea,Earl Grey,Illinois,50,80,50,130,Regular,5
2012-11-01T00:00:00,847,Central,Major Market,1778,211,423,212,59,24,129,83,423,Beans,Espresso,Decaf Espresso,Illinois,270,270,200,540,Decaf,-71
2012-12-01T00:00:00,847,Central,Major Market,1191,224,534,310,73,43,194,116,534,Beans,Coffee,Colombian,Illinois,220,300,190,520,Regular,4
2013-11-01T00:00:00,847,Central,Major Market,803,113,278,165,36,-28,157,59,296,Beans,Coffee,Decaf Irish Cream,Illinois,110,160,110,270,Decaf,47
2013-11-01T00:00:00,847,Central,Major Market,1778,211,423,212,59,-38,191,83,451,Beans,Espresso,Decaf Espresso,Illinois,270,270,200,540,Decaf,-9
2012-10-01T00:00:00,850,East,Major Market,871,38,94,56,10,11,35,21,94,Leaves,Tea,Darjeeling,Florida,40,60,50,100,Regular,-15
2012-10-01T00:00:00,850,East,Major Market,385,56,126,70,21,33,16,54,126,Leaves,Herbal Tea,Lemon,Florida,30,30,20,60,Decaf,-4
2013-11-01T00:00:00,857,East,Major Market,410,55,124,69,20,27,22,54,132,Leaves,Herbal Tea,Lemon,Massachusetts,40,50,20,90,Decaf,2
2012-12-01T00:00:00,857,East,Major Market,490,29,73,44,8,11,25,19,73,Leaves,Tea,Green Tea,Massachusetts,30,40,30,70,Regular,-5
2012-10-01T00:00:00,857,East,Major Market,-3004,72,474,402,23,31,348,54,474,Beans,Coffee,Colombian,Massachusetts,50,350,330,400,Regular,18
2013-10-01T00:00:00,857,East,Major Market,-3004,72,474,402,23,-137,516,54,505,Beans,Coffee,Colombian,Massachusetts,50,350,330,400,Regular,186
2013-11-01T00:00:00,857,East,Major Market,-3287,75,454,379,24,-126,481,55,484,Beans,Coffee,Colombian,Massachusetts,60,340,300,400,Regular,181
2013-12-01T00:00:00,857,East,Major Market,1319,153,306,153,42,-18,129,66,326,Beans,Espresso,Regular Espresso,Massachusetts,150,140,80,290,Regular,49
2012-10-01T00:00:00,860,East,Small Market,375,47,111,64,15,28,21,43,111,Beans,Espresso,Decaf Espresso,Connecticut,30,60,50,90,Decaf,-29
2012-10-01T00:00:00,860,East,Small Market,881,40,99,59,11,12,36,23,99,Leaves,Tea,Darjeeling,Connecticut,40,60,50,100,Regular,-14
2013-12-01T00:00:00,860,East,Small Market,619,68,153,85,25,20,40,58,163,Leaves,Herbal Tea,Lemon,Connecticut,50,60,20,110,Decaf,20
2012-10-01T00:00:00,860,East,Small Market,1053,65,142,77,20,22,35,42,142,Leaves,Herbal Tea,Mint,Connecticut,30,50,50,80,Decaf,-15
2012-11-01T00:00:00,860,East,Small Market,380,53,124,71,17,28,26,45,124,Beans,Espresso,Decaf Espresso,Connecticut,50,70,40,120,Decaf,-14
2012-11-01T00:00:00,860,East,Small Market,601,82,184,102,31,33,38,64,184,Leaves,Herbal Tea,Lemon,Connecticut,60,70,30,130,Decaf,8
2012-12-01T00:00:00,860,East,Small Market,898,50,123,73,14,12,47,26,123,Leaves,Tea,Darjeeling,Connecticut,50,70,50,120,Regular,-3
2013-11-01T00:00:00,860,East,Small Market,885,54,132,78,15,-13,76,27,141,Leaves,Tea,Darjeeling,Connecticut,50,80,60,130,Regular,16
2012-10-01T00:00:00,860,East,Small Market,1119,125,313,188,41,32,115,73,313,Beans,Coffee,Colombian,Connecticut,100,160,130,260,Regular,-15
2012-12-01T00:00:00,863,East,Major Market,863,34,85,51,9,12,30,21,85,Leaves,Tea,Green Tea,Florida,30,50,40,80,Regular,-10
2012-10-01T00:00:00,863,East,Major Market,851,48,118,70,13,11,46,24,118,Leaves,Tea,Green Tea,Florida,50,70,60,120,Regular,-14
2013-10-01T00:00:00,904,East,Major Market,1055,80,174,94,24,-1,71,46,185,Leaves,Herbal Tea,Mint,Florida,40,50,40,90,Decaf,31
2013-11-01T00:00:00,904,East,Major Market,856,31,78,47,8,-3,42,19,83,Leaves,Tea,Green Tea,Florida,30,50,40,80,Regular,2
2013-12-01T00:00:00,904,East,Major Market,567,24,56,32,7,7,18,20,60,Leaves,Herbal Tea,Chamomile,Florida,10,30,20,40,Decaf,-2
2013-10-01T00:00:00,904,East,Major Market,573,22,51,29,7,7,15,19,54,Leaves,Herbal Tea,Chamomile,Florida,0,20,20,20,Decaf,-5
2013-11-01T00:00:00,904,East,Major Market,666,102,245,143,31,-20,132,54,261,Beans,Coffee,Decaf Irish Cream,Florida,90,130,90,220,Decaf,42
2012-11-01T00:00:00,909,West,Major Market,3909,173,146,-27,57,43,-127,100,146,Beans,Coffee,Decaf Irish Cream,California,200,-30,-130,170,Decaf,3
2013-10-01T00:00:00,909,West,Major Market,2555,122,109,-13,39,58,-110,61,116,Beans,Coffee,Amaretto,California,170,-20,-60,150,Regular,-50
2013-11-01T00:00:00,914,East,Major Market,589,50,123,73,14,-11,70,26,131,Leaves,Tea,Green Tea,New York,50,70,50,120,Regular,20
2012-11-01T00:00:00,914,East,Major Market,4742,225,160,-65,69,22,-156,91,160,Leaves,Herbal Tea,Mint,New York,160,-50,-120,110,Decaf,-36
2013-10-01T00:00:00,914,East,Major Market,3142,125,69,-56,113,131,-300,146,74,Beans,Espresso,Caffe Mocha,New York,110,-60,-170,50,Regular,-130
2013-11-01T00:00:00,914,East,Major Market,3385,121,61,-60,109,131,-300,142,65,Beans,Espresso,Caffe Mocha,New York,110,-60,-190,50,Regular,-110
2013-11-01T00:00:00,914,East,Major Market,930,118,290,172,33,-49,188,45,309,Leaves,Tea,Earl Grey,New York,120,170,130,290,Regular,58
2012-11-01T00:00:00,915,South,Major Market,536,40,92,52,13,13,26,26,92,Beans,Coffee,Decaf Irish Cream,Texas,40,60,40,100,Decaf,-14
2012-10-01T00:00:00,915,South,Major Market,580,76,187,111,21,12,78,33,187,Beans,Espresso,Decaf Espresso,Texas,40,80,80,120,Decaf,-2
2013-11-01T00:00:00,915,South,Major Market,930,118,290,172,33,-49,188,45,309,Beans,Espresso,Caffe Mocha,Texas,90,130,100,220,Regular,88
2012-12-01T00:00:00,916,West,Major Market,1820,250,501,251,70,24,157,94,501,Beans,Espresso,Caffe Latte,California,240,240,160,480,Regular,-3
2012-12-01T00:00:00,916,West,Major Market,959,123,302,179,34,11,134,45,302,Leaves,Tea,Darjeeling,California,90,130,110,220,Regular,24
2013-11-01T00:00:00,916,West,Major Market,2758,113,116,3,36,50,-83,59,124,Beans,Coffee,Amaretto,California,130,0,-50,130,Regular,-33
2013-11-01T00:00:00,916,West,Major Market,912,121,289,168,109,20,39,142,308,Beans,Espresso,Caffe Mocha,California,110,170,40,280,Regular,-1
2013-12-01T00:00:00,916,West,Major Market,1003,86,210,124,24,-32,132,35,224,Leaves,Herbal Tea,Chamomile,California,80,110,80,190,Decaf,52
2013-11-01T00:00:00,917,East,Major Market,933,211,675,464,59,-160,565,83,719,Beans,Espresso,Regular Espresso,New York,200,460,390,660,Regular,175
2012-10-01T00:00:00,918,South,Small Market,859,27,66,39,7,11,21,18,66,Beans,Coffee,Decaf Irish Cream,Oklahoma,30,60,60,90,Decaf,-39
2012-11-01T00:00:00,918,South,Small Market,391,54,121,67,20,34,13,54,121,Leaves,Herbal Tea,Chamomile,Oklahoma,50,60,20,110,Decaf,-7
2013-12-01T00:00:00,918,South,Small Market,870,33,82,49,9,-2,42,21,87,Beans,Coffee,Decaf Irish Cream,Oklahoma,30,60,50,90,Decaf,-8
2012-11-01T00:00:00,918,South,Small Market,482,32,80,48,8,11,29,19,80,Beans,Espresso,Caffe Mocha,Oklahoma,20,40,30,60,Regular,-1
2012-10-01T00:00:00,918,South,Small Market,572,90,205,115,29,12,74,41,205,Beans,Coffee,Colombian,Oklahoma,130,160,140,290,Regular,-66
2012-11-01T00:00:00,918,South,Small Market,798,78,197,119,25,32,62,57,197,Beans,Espresso,Decaf Espresso,Oklahoma,60,90,40,150,Decaf,22
2012-11-01T00:00:00,918,South,Small Market,561,88,200,112,29,12,71,41,200,Beans,Coffee,Colombian,Oklahoma,100,130,90,230,Regular,-19
2012-11-01T00:00:00,918,South,Small Market,-2003,102,245,143,31,23,89,54,245,Beans,Espresso,Caffe Latte,Oklahoma,80,100,60,180,Regular,29
2012-12-01T00:00:00,918,South,Small Market,-2248,134,320,186,41,24,121,65,320,Beans,Espresso,Caffe Latte,Oklahoma,100,140,90,240,Regular,31
2013-10-01T00:00:00,918,South,Small Market,572,90,205,115,29,-24,110,41,218,Beans,Coffee,Colombian,Oklahoma,130,160,140,290,Regular,-30
2013-10-01T00:00:00,918,South,Small Market,683,96,230,134,87,22,25,117,245,Leaves,Herbal Tea,Lemon,Oklahoma,80,120,40,200,Decaf,-15
2013-11-01T00:00:00,918,South,Small Market,561,88,200,112,29,-22,105,41,213,Beans,Coffee,Colombian,Oklahoma,100,130,90,230,Regular,15
2013-12-01T00:00:00,918,South,Small Market,817,88,221,133,29,-3,107,61,236,Beans,Espresso,Decaf Espresso,Oklahoma,60,110,60,170,Decaf,47
2013-12-01T00:00:00,918,South,Small Market,-2248,134,320,186,41,-35,180,65,341,Beans,Espresso,Caffe Latte,Oklahoma,100,140,90,240,Regular,90
2012-12-01T00:00:00,920,Central,Small Market,320,41,107,66,12,24,30,36,107,Leaves,Herbal Tea,Chamomile,Wisconsin,30,60,30,90,Decaf,0
2012-12-01T00:00:00,920,Central,Small Market,627,55,131,76,49,30,-3,79,131,Leaves,Tea,Earl Grey,Wisconsin,40,60,0,100,Regular,-3
2013-12-01T00:00:00,920,Central,Small Market,320,41,107,66,12,9,45,36,114,Leaves,Herbal Tea,Chamomile,Wisconsin,30,60,30,90,Decaf,15
2013-11-01T00:00:00,920,Central,Small Market,570,22,52,30,7,7,16,19,55,Beans,Espresso,Decaf Espresso,Wisconsin,20,40,30,60,Decaf,-14
2012-11-01T00:00:00,920,Central,Small Market,321,53,141,88,16,24,48,40,141,Leaves,Herbal Tea,Chamomile,Wisconsin,50,80,50,130,Decaf,-2
2013-12-01T00:00:00,920,Central,Small Market,403,65,145,80,24,23,33,58,155,Beans,Coffee,Amaretto,Wisconsin,60,80,30,140,Regular,3
2012-11-01T00:00:00,920,Central,Small Market,1063,75,164,89,23,21,45,44,164,Beans,Espresso,Caffe Mocha,Wisconsin,90,110,70,200,Regular,-25
2013-10-01T00:00:00,920,Central,Small Market,547,86,202,116,28,-3,91,55,215,Beans,Coffee,Decaf Irish Cream,Wisconsin,80,120,100,200,Decaf,-9
2013-11-01T00:00:00,920,Central,Small Market,557,77,180,103,25,2,76,52,192,Beans,Coffee,Decaf Irish Cream,Wisconsin,70,100,60,170,Decaf,16
2013-10-01T00:00:00,925,West,Major Market,971,108,265,157,30,-44,171,42,282,Leaves,Herbal Tea,Chamomile,California,80,130,120,210,Decaf,51
2012-11-01T00:00:00,936,South,Major Market,424,46,114,68,14,23,31,37,114,Leaves,Herbal Tea,Lemon,Texas,40,60,30,100,Decaf,1
2013-11-01T00:00:00,936,South,Major Market,536,40,92,52,13,0,39,26,98,Beans,Coffee,Decaf Irish Cream,Texas,40,60,40,100,Decaf,-1
2013-11-01T00:00:00,936,South,Major Market,411,59,138,79,19,13,47,47,147,Leaves,Herbal Tea,Chamomile,Texas,50,70,40,120,Decaf,7
2012-10-01T00:00:00,936,South,Major Market,1246,239,520,281,74,22,185,96,520,Beans,Coffee,Colombian,Texas,350,420,340,770,Regular,-155
2012-11-01T00:00:00,937,Central,Major Market,482,32,80,48,8,11,29,19,80,Leaves,Herbal Tea,Chamomile,Ohio,30,40,30,70,Decaf,-1
2012-12-01T00:00:00,937,Central,Major Market,490,29,73,44,8,11,25,19,73,Leaves,Herbal Tea,Chamomile,Ohio,20,40,30,60,Decaf,-5
2012-10-01T00:00:00,937,Central,Major Market,419,43,107,64,13,23,28,36,107,Beans,Coffee,Colombian,Ohio,30,70,60,100,Regular,-32
2013-10-01T00:00:00,937,Central,Major Market,419,43,107,64,13,9,42,36,114,Beans,Coffee,Colombian,Ohio,30,70,60,100,Regular,-18
2012-10-01T00:00:00,937,Central,Major Market,480,21,53,32,5,11,16,16,53,Leaves,Herbal Tea,Chamomile,Ohio,0,30,30,30,Decaf,-14
2013-10-01T00:00:00,937,Central,Major Market,480,21,53,32,5,3,24,16,56,Leaves,Herbal Tea,Chamomile,Ohio,0,30,30,30,Decaf,-6
2013-10-01T00:00:00,937,Central,Major Market,859,27,66,39,7,2,30,19,70,Leaves,Herbal Tea,Lemon,Ohio,10,30,30,40,Decaf,0
2013-11-01T00:00:00,937,Central,Major Market,410,55,124,69,20,25,24,53,132,Beans,Espresso,Decaf Espresso,Ohio,70,80,40,150,Decaf,-16
2013-12-01T00:00:00,937,Central,Major Market,1319,153,306,153,42,-18,129,66,326,Beans,Espresso,Caffe Mocha,Ohio,190,200,140,390,Regular,-11
2013-12-01T00:00:00,949,West,Major Market,1820,250,501,251,70,-52,233,94,534,Beans,Espresso,Caffe Latte,California,240,240,160,480,Regular,73
2012-10-01T00:00:00,951,West,Major Market,3654,154,130,-24,50,43,-117,93,130,Beans,Coffee,Decaf Irish Cream,California,220,-30,-100,190,Decaf,-17
2012-11-01T00:00:00,951,West,Major Market,2580,249,623,374,87,52,235,139,623,Beans,Coffee,Colombian,California,290,450,310,740,Regular,-75
2012-12-01T00:00:00,951,West,Major Market,2947,127,102,-25,40,23,-88,63,102,Beans,Coffee,Amaretto,California,150,-30,-90,120,Regular,2
2013-10-01T00:00:00,951,West,Major Market,1246,239,520,281,74,-69,276,95,554,Leaves,Herbal Tea,Lemon,California,190,220,170,410,Decaf,106
2013-11-01T00:00:00,951,West,Major Market,1778,211,423,212,59,-38,191,83,451,Beans,Espresso,Caffe Latte,California,200,210,140,410,Regular,51
2013-12-01T00:00:00,951,West,Major Market,4216,224,192,-32,73,116,-221,117,205,Beans,Coffee,Decaf Irish Cream,California,260,-40,-150,220,Decaf,-71
2012-11-01T00:00:00,954,East,Major Market,1063,75,164,89,23,22,44,45,164,Leaves,Herbal Tea,Mint,Florida,50,60,30,110,Decaf,14
2012-12-01T00:00:00,954,East,Major Market,403,65,145,80,24,33,23,57,145,Leaves,Herbal Tea,Lemon,Florida,40,60,20,100,Decaf,3
2013-10-01T00:00:00,954,East,Major Market,788,82,205,123,27,1,95,59,218,Beans,Coffee,Colombian,Florida,60,110,90,170,Regular,5
2013-12-01T00:00:00,956,South,Major Market,531,43,99,56,14,-3,45,26,106,Beans,Coffee,Decaf Irish Cream,Texas,50,60,40,110,Decaf,5
2012-11-01T00:00:00,956,South,Major Market,1272,225,490,265,69,22,174,91,490,Beans,Coffee,Colombian,Texas,260,320,230,580,Regular,-56
2012-10-01T00:00:00,959,East,Small Market,593,79,177,98,30,34,34,64,177,Leaves,Herbal Tea,Lemon,Connecticut,40,50,30,90,Decaf,4
2012-12-01T00:00:00,959,East,Small Market,818,33,82,49,9,12,28,21,82,Leaves,Tea,Green Tea,Connecticut,30,50,40,80,Regular,-12
2013-11-01T00:00:00,959,East,Small Market,1060,69,150,81,21,4,56,43,160,Leaves,Herbal Tea,Mint,Connecticut,50,50,30,100,Decaf,26
2013-12-01T00:00:00,959,East,Small Market,818,33,82,49,9,-2,42,21,87,Leaves,Tea,Green Tea,Connecticut,30,50,40,80,Regular,2
2012-10-01T00:00:00,959,East,Small Market,806,24,60,36,6,12,18,18,60,Leaves,Tea,Green Tea,Connecticut,20,40,40,60,Regular,-22
2012-12-01T00:00:00,959,East,Small Market,392,49,114,65,16,28,21,44,114,Beans,Espresso,Decaf Espresso,Connecticut,40,70,40,110,Decaf,-19
2013-12-01T00:00:00,959,East,Small Market,898,50,123,73,14,-11,70,26,131,Leaves,Tea,Darjeeling,Connecticut,50,70,50,120,Regular,20
2012-11-01T00:00:00,959,East,Small Market,885,54,132,78,15,12,51,27,132,Leaves,Tea,Darjeeling,Connecticut,50,80,60,130,Regular,-9
2013-10-01T00:00:00,959,East,Small Market,606,60,144,84,54,29,1,83,153,Beans,Espresso,Caffe Mocha,Connecticut,40,90,40,130,Regular,-39
2013-12-01T00:00:00,959,East,Small Market,1166,115,289,174,37,-19,156,69,308,Beans,Coffee,Colombian,Connecticut,100,160,110,260,Regular,46
2012-10-01T00:00:00,970,Central,Major Market,405,52,123,71,17,28,26,45,123,Leaves,Herbal Tea,Mint,Colorado,30,60,50,90,Decaf,-24
2012-11-01T00:00:00,970,Central,Major Market,536,40,92,52,13,12,27,25,92,Beans,Coffee,Colombian,Colorado,30,60,40,90,Regular,-13
2012-12-01T00:00:00,970,Central,Major Market,521,47,112,65,42,29,-6,71,112,Leaves,Herbal Tea,Lemon,Colorado,40,60,0,100,Decaf,-6
2013-10-01T00:00:00,970,Central,Major Market,405,52,123,71,17,15,39,45,131,Leaves,Herbal Tea,Mint,Colorado,30,60,50,90,Decaf,-11
2013-12-01T00:00:00,970,Central,Major Market,424,54,127,73,17,13,43,44,135,Leaves,Herbal Tea,Mint,Colorado,50,60,30,110,Decaf,13
2012-12-01T00:00:00,970,Central,Major Market,531,43,99,56,14,13,29,27,99,Beans,Coffee,Colombian,Colorado,40,50,30,90,Regular,-1
2013-10-01T00:00:00,970,Central,Major Market,1037,54,118,64,16,8,40,37,126,Leaves,Tea,Earl Grey,Colorado,30,50,40,80,Regular,0
2013-12-01T00:00:00,970,Central,Major Market,531,43,99,56,14,-1,43,27,106,Beans,Coffee,Colombian,Colorado,40,50,30,90,Regular,13
2013-12-01T00:00:00,970,Central,Major Market,1054,53,116,63,16,8,39,37,124,Leaves,Tea,Earl Grey,Colorado,40,50,20,90,Regular,19
2013-11-01T00:00:00,970,Central,Major Market,509,52,125,73,47,32,-6,77,133,Leaves,Herbal Tea,Lemon,Colorado,40,70,10,110,Decaf,-16
2013-11-01T00:00:00,970,Central,Major Market,411,59,138,79,19,13,47,47,147,Leaves,Herbal Tea,Mint,Colorado,50,70,40,120,Decaf,7
2012-10-01T00:00:00,970,Central,Major Market,915,123,302,179,34,12,133,46,302,Beans,Coffee,Amaretto,Colorado,120,180,160,300,Regular,-27
2012-11-01T00:00:00,970,Central,Major Market,984,81,198,117,22,11,84,33,198,Beans,Coffee,Decaf Irish Cream,Colorado,80,110,80,190,Decaf,4
2012-11-01T00:00:00,970,Central,Major Market,930,118,290,172,33,11,128,44,290,Beans,Coffee,Amaretto,Colorado,110,170,130,280,Regular,-2
2012-11-01T00:00:00,970,Central,Major Market,1283,181,363,182,50,25,107,75,363,Leaves,Herbal Tea,Chamomile,Colorado,170,160,100,330,Decaf,7
2012-12-01T00:00:00,970,Central,Major Market,677,67,168,101,22,32,47,54,168,Beans,Espresso,Decaf Espresso,Colorado,80,130,80,210,Decaf,-33
2012-12-01T00:00:00,970,Central,Major Market,601,54,133,79,15,11,53,26,133,Beans,Espresso,Caffe Mocha,Colorado,60,110,90,170,Regular,-37
2013-10-01T00:00:00,970,Central,Major Market,650,72,182,110,23,4,83,54,194,Beans,Espresso,Decaf Espresso,Colorado,100,160,130,260,Decaf,-47
2013-10-01T00:00:00,970,Central,Major Market,580,76,187,111,21,-27,117,32,199,Beans,Espresso,Caffe Mocha,Colorado,100,180,170,280,Regular,-53
2013-10-01T00:00:00,970,Central,Major Market,572,90,205,115,29,-24,110,41,218,Leaves,Tea,Green Tea,Colorado,50,90,80,140,Regular,30
2013-11-01T00:00:00,970,Central,Major Market,659,75,189,114,24,4,86,56,201,Beans,Espresso,Decaf Espresso,Colorado,90,150,100,240,Decaf,-14
2013-11-01T00:00:00,970,Central,Major Market,1283,181,363,182,50,-27,159,75,387,Leaves,Herbal Tea,Chamomile,Colorado,170,160,100,330,Decaf,59
2013-11-01T00:00:00,970,Central,Major Market,561,88,200,112,29,-21,104,42,213,Leaves,Tea,Green Tea,Colorado,70,90,60,160,Regular,44
2013-12-01T00:00:00,970,Central,Major Market,601,54,133,79,15,-15,79,26,142,Beans,Espresso,Caffe Mocha,Colorado,60,110,90,170,Regular,-11
2013-12-01T00:00:00,970,Central,Major Market,1319,153,306,153,42,-18,129,66,326,Leaves,Herbal Tea,Chamomile,Colorado,140,140,80,280,Decaf,49
2012-10-01T00:00:00,971,West,Small Market,788,82,205,123,27,32,64,59,205,Leaves,Tea,Earl Grey,Oregon,30,60,50,90,Regular,14
2012-10-01T00:00:00,971,West,Small Market,656,91,218,127,28,23,76,51,218,Leaves,Tea,Green Tea,Oregon,40,60,50,100,Regular,26
2013-10-01T00:00:00,971,West,Small Market,404,54,120,66,20,28,18,54,128,Beans,Espresso,Caffe Latte,Oregon,40,60,40,100,Regular,-22
2012-12-01T00:00:00,971,West,Small Market,422,46,103,57,17,34,6,51,103,Beans,Espresso,Caffe Latte,Oregon,40,50,10,90,Regular,-4
2013-12-01T00:00:00,971,West,Small Market,422,46,103,57,17,31,9,51,110,Beans,Espresso,Caffe Latte,Oregon,40,50,10,90,Regular,-1
2012-10-01T00:00:00,971,West,Small Market,405,52,123,71,17,27,27,44,123,Beans,Espresso,Caffe Mocha,Oregon,30,70,60,100,Regular,-33
2012-10-01T00:00:00,971,West,Small Market,820,25,61,36,7,12,17,19,61,Leaves,Herbal Tea,Chamomile,Oregon,10,30,30,40,Decaf,-13
2012-12-01T00:00:00,971,West,Small Market,490,29,73,44,8,11,25,19,73,Leaves,Tea,Darjeeling,Oregon,20,30,30,50,Regular,-5
2013-10-01T00:00:00,971,West,Small Market,820,25,61,36,7,4,25,19,65,Leaves,Herbal Tea,Chamomile,Oregon,10,30,30,40,Decaf,-5
2013-11-01T00:00:00,971,West,Small Market,509,52,125,73,47,32,-6,77,133,Beans,Coffee,Amaretto,Oregon,60,80,10,140,Regular,-16
2012-10-01T00:00:00,971,West,Small Market,419,43,107,64,13,22,29,35,107,Beans,Coffee,Decaf Irish Cream,Oregon,50,100,80,150,Decaf,-51
2012-10-01T00:00:00,971,West,Small Market,503,51,122,71,46,30,-5,76,122,Beans,Coffee,Amaretto,Oregon,70,100,50,170,Regular,-55
2012-10-01T00:00:00,971,West,Small Market,463,60,144,84,19,44,21,63,144,Beans,Coffee,Colombian,Oregon,80,130,90,210,Regular,-69
2012-10-01T00:00:00,971,West,Small Market,572,90,205,115,29,13,73,42,205,Leaves,Herbal Tea,Lemon,Oregon,60,100,90,160,Decaf,-17
2012-11-01T00:00:00,971,West,Small Market,470,53,128,75,17,44,14,61,128,Beans,Coffee,Colombian,Oregon,60,90,40,150,Regular,-26
2012-11-01T00:00:00,971,West,Small Market,561,88,200,112,29,13,70,42,200,Leaves,Herbal Tea,Lemon,Oregon,80,100,70,180,Decaf,0
2012-11-01T00:00:00,971,West,Small Market,798,78,197,119,25,32,62,57,197,Leaves,Tea,Earl Grey,Oregon,50,90,50,140,Regular,12
2012-11-01T00:00:00,971,West,Small Market,666,102,245,143,31,23,89,54,245,Leaves,Tea,Green Tea,Oregon,70,100,70,170,Regular,19
2012-12-01T00:00:00,971,West,Small Market,1319,153,306,153,42,24,87,66,306,Beans,Espresso,Decaf Espresso,Oregon,150,140,80,290,Decaf,7
2012-12-01T00:00:00,971,West,Small Market,817,88,221,133,29,31,73,60,221,Leaves,Tea,Earl Grey,Oregon,60,100,60,160,Regular,13
2013-10-01T00:00:00,971,West,Small Market,419,43,107,64,13,8,43,35,114,Beans,Coffee,Decaf Irish Cream,Oregon,50,100,80,150,Decaf,-37
2013-10-01T00:00:00,971,West,Small Market,480,21,53,32,5,3,24,16,56,Leaves,Tea,Darjeeling,Oregon,0,20,20,20,Regular,4
2013-11-01T00:00:00,971,West,Small Market,1283,181,363,182,50,-28,160,74,387,Beans,Espresso,Decaf Espresso,Oregon,170,180,120,350,Decaf,40
2013-11-01T00:00:00,971,West,Small Market,666,102,245,143,31,-20,132,54,261,Leaves,Tea,Green Tea,Oregon,70,100,70,170,Regular,62
2013-12-01T00:00:00,971,West,Small Market,1319,153,306,153,42,-18,129,66,326,Beans,Espresso,Decaf Espresso,Oregon,150,140,80,290,Decaf,49
2013-12-01T00:00:00,971,West,Small Market,817,88,221,133,29,-4,108,60,236,Leaves,Tea,Earl Grey,Oregon,60,100,60,160,Regular,48
2012-12-01T00:00:00,972,South,Major Market,1321,241,525,284,74,22,188,96,525,Beans,Coffee,Colombian,Texas,280,340,240,620,Regular,-52
2012-12-01T00:00:00,972,South,Major Market,959,123,302,179,34,12,133,46,302,Beans,Espresso,Caffe Mocha,Texas,90,140,110,230,Regular,23
2013-10-01T00:00:00,978,East,Major Market,859,27,66,39,7,2,30,19,70,Leaves,Tea,Darjeeling,Massachusetts,20,50,50,70,Regular,-20
2013-11-01T00:00:00,978,East,Major Market,482,32,80,48,8,-3,43,19,85,Leaves,Tea,Green Tea,Massachusetts,30,50,40,80,Regular,3
2013-12-01T00:00:00,978,East,Major Market,571,47,99,52,42,40,-30,72,106,Beans,Espresso,Caffe Mocha,Massachusetts,40,50,-10,90,Regular,-20
2013-12-01T00:00:00,978,East,Major Market,870,33,82,49,9,-3,43,20,87,Leaves,Tea,Darjeeling,Massachusetts,30,50,40,80,Regular,3
2012-11-01T00:00:00,978,East,Major Market,-3287,75,454,379,24,31,324,55,454,Beans,Coffee,Colombian,Massachusetts,60,340,300,400,Regular,24
2012-12-01T00:00:00,985,South,Small Market,-1053,55,131,76,49,30,-3,79,131,Beans,Espresso,Caffe Latte,Louisiana,40,60,0,100,Regular,-3
2012-12-01T00:00:00,985,South,Small Market,320,41,107,66,12,23,31,35,107,Beans,Espresso,Caffe Mocha,Louisiana,30,50,20,80,Regular,11
2012-10-01T00:00:00,985,South,Small Market,329,60,159,99,18,23,58,41,159,Beans,Espresso,Caffe Mocha,Louisiana,30,70,70,100,Regular,-12
2012-12-01T00:00:00,985,South,Small Market,619,68,153,85,25,34,26,59,153,Leaves,Herbal Tea,Lemon,Louisiana,60,80,30,140,Decaf,-4
2013-10-01T00:00:00,985,South,Small Market,851,48,118,70,13,-10,67,25,126,Beans,Coffee,Decaf Irish Cream,Louisiana,70,90,80,160,Decaf,-13
2013-11-01T00:00:00,985,South,Small Market,552,101,231,130,33,-29,126,45,246,Leaves,Herbal Tea,Chamomile,Louisiana,90,120,80,210,Decaf,46
2013-12-01T00:00:00,985,South,Small Market,845,49,120,71,13,-10,68,25,128,Beans,Coffee,Colombian,Louisiana,50,90,70,140,Regular,-2
2013-12-01T00:00:00,985,South,Small Market,540,94,214,120,31,-25,114,43,228,Leaves,Herbal Tea,Chamomile,Louisiana,80,110,70,190,Decaf,44
